Being There

During the course of play you will be taken to a series of locations. In each location you can do various things by typing commands into the text prompt. Try things like:

listen
examine the stripe
touch the street
dance on the sidewalk
climb the tree
taste the flower

Please press SPACE to continue.

>x me
As good-looking as ever.

>x me
As good-looking as ever.

>x you
You can't see any such thing.

>x her
I'm not sure what "her" refers to.

>z
Time passes.

>z
Time passes.

* * *

Being There

During the course of play you will be taken to a series of locations. In each location you can do various things by typing commands into the text prompt. Try things like:

listen
examine the stripe
touch the street
dance on the sidewalk
climb the tree
taste the flower

Please press SPACE to continue.

>z
Time passes.

>z
There is no time. You must leave this place.

>z
There is no time. You must leave this place.

>z
There is no time.

>z
There is no time.

>z
Time passes.

Life is good.

>z
Time passes.

* * *

>z
Time passes.

Life is good.

I beg your pardon?

>z
Time passes.

The breeze ruffles your hair.

>z
Time passes.

>z
Time passes.

A bird flies by, and looks at you.

>z
Time passes.

>z
Time passes.

It feels like you've been here before.

>z
Time passes.

>z
Time passes.

You hear rain in the distance.

>sit down
You are now seated. You feel a pebble beneath your buttock.

Above you is the sky.

>stand up
You are now standing. You feel tall.

The ether shifts around you.

>sit on the grass
You are now seated on the grass. 
You take a deep breath.

>stand up
You are now standing on the grass.

>z
Time passes.

You close your eyes, but the world is still there, in front of you.

>sit down
You are now seated on the grass. Cross-legged.

>stand up
You are now standing on the grass. 
The earth spins slowly.

>sit down
You are now seated on the grass. Legs out in front of you.

You feel a breeze behind you.

>dance
You are now dancing on the grass. You spin and you spin, until you can't see straight.

>eat stripe
(first taking the yellow stripe of paint)
That's hardly portable.

>taste stripe
It tastes earthy and yellow, and feels like hard paint. A blossom sticks to your tongue.

* * *

>z
There is no time.

>n
There is no time.

* * *

>z
There is no time.

I beg your pardon?

>z
Time passes.

-6
There is no time.

>z
Time passes.

-7
There is no time.

* * *

>z
There is no time. You must leave this place.

>n
There is no time. You must leave this place.

* * *

>z
There is no time. You must leave this place.

>look
There is no time. You must leave this place.

* * *

>z
There is no time. You must leave this place.

I beg your pardon?

>z
Time passes.

-4
There is no time.

>z
Time passes.

-5
There is no time.

* * *

>z
Time passes.

>s
Sandlot
You follow the stream, walking south, until the stream becomes a river and you can no longer touch the bottom. Then you float with your eyes closed, until the river washes you up on an asphalt shore, where two boys play baseball at dusk.

You feel your time is drawing short. You won't be able to stay here long.

-1

>n
There is no time. You must leave this place.

A Group of Boys
You follow the stream, walking south, until the stream becomes a river and you can no longer touch the bottom. Then you float with your eyes closed, until the river washes you up on an asphalt shore, where two boys play baseball at dusk.

You feel your time is drawing short. You won't be able to stay here long.

A Pavilion
You run far this time. Past all the empty places, until you find two boys playing baseball at dusk in an empty lot.

>s
A Group of Boys
You follow the stream, walking south, until the stream becomes a river and you can no longer touch the bottom. Then you float with your eyes closed, until the river washes you up on an asphalt shore, where two boys play baseball at dusk.

You feel your time is drawing short. You won't be able to stay here long.

>s
Sandlot
You follow the stream, walking south, until the stream becomes a river and you can no longer touch the bottom. Then you float with your eyes closed, until the river washes you up on an asphalt shore, where two boys play baseball at dusk.

You feel your time is drawing short. You won't be able to stay here long.

-2

>s
There is no time. You must leave this place.

A Group of Boys
You follow the stream, walking south, until the stream becomes a river and you can no longer touch the bottom. Then you float with your eyes closed, until the river washes you up on an asphalt shore, where two boys play baseball at dusk.

You feel your time is drawing short. You won't be able to stay here long.

Sandlot
You follow the stream, walking south, until the stream becomes a river and you can no longer touch the bottom. Then you float with your eyes closed, until the river washes you up on an asphalt shore, where two boys play baseball at dusk.

You feel your time is drawing short. You won't be able to stay here long.

-3

>s
There is no time. You must leave this place.

A Group of Boys
You follow the stream, walking south, until the stream becomes a river and you can no longer touch the bottom. Then you float with your eyes closed, until the river washes you up on an asphalt shore, where two boys play baseball at dusk.

You feel your time is drawing short. You won't be able to stay here long.

Sandlot
You follow the stream, walking south, until the stream becomes a river and you can no longer touch the bottom. Then you float with your eyes closed, until the river washes you up on an asphalt shore, where two boys play baseball at dusk.

You feel your time is drawing short. You won't be able to stay here long.

-4

>n
There is no time. You must leave this place.

A Group of Boys
You follow the stream, walking south, until the stream becomes a river and you can no longer touch the bottom. Then you float with your eyes closed, until the river washes you up on an asphalt shore, where two boys play baseball at dusk.

You feel your time is drawing short. You won't be able to stay here long.

A Pavilion
You run far this time. Past all the empty places, until you find two boys playing baseball at dusk in an empty lot.

* * *

>s
A Group of Boys
You follow the stream, walking south, until the stream becomes a river and you can no longer touch the bottom. Then you float with your eyes closed, until the river washes you up on an asphalt shore, where two boys play baseball at dusk.

You feel your time is drawing short. You won't be able to stay here long.

>n
A Pavilion
You run far this time. Past all the empty places, until you find two boys playing baseball at dusk in an empty lot.

>s
A Group of Boys
You follow the stream, walking south, until the stream becomes a river and you can no longer touch the bottom. Then you float with your eyes closed, until the river washes you up on an asphalt shore, where two boys play baseball at dusk.

You feel your time is drawing short. You won't be able to stay here long.

>s
Sandlot
You follow the stream, walking south, until the stream becomes a river and you can no longer touch the bottom. Then you float with your eyes closed, until the river washes you up on an asphalt shore, where two boys play baseball at dusk.

You feel your time is drawing short. You won't be able to stay here long.

-5

>s
There is no time. You must leave this place.

A Group of Boys
You follow the stream, walking south, until the stream becomes a river and you can no longer touch the bottom. Then you float with your eyes closed, until the river washes you up on an asphalt shore, where two boys play baseball at dusk.

You feel your time is drawing short. You won't be able to stay here long.

Sandlot
You follow the stream, walking south, until the stream becomes a river and you can no longer touch the bottom. Then you float with your eyes closed, until the river washes you up on an asphalt shore, where two boys play baseball at dusk.

You feel your time is drawing short. You won't be able to stay here long.

-6

>s
There is no time. You must leave this place.

A Group of Boys
You follow the stream, walking south, until the stream becomes a river and you can no longer touch the bottom. Then you float with your eyes closed, until the river washes you up on an asphalt shore, where two boys play baseball at dusk.

You feel your time is drawing short. You won't be able to stay here long.

Sandlot
You follow the stream, walking south, until the stream becomes a river and you can no longer touch the bottom. Then you float with your eyes closed, until the river washes you up on an asphalt shore, where two boys play baseball at dusk.

You feel your time is drawing short. You won't be able to stay here long.

-7

>n
There is no time. You must leave this place.

A Group of Boys
You follow the stream, walking south, until the stream becomes a river and you can no longer touch the bottom. Then you float with your eyes closed, until the river washes you up on an asphalt shore, where two boys play baseball at dusk.

You feel your time is drawing short. You won't be able to stay here long.

A Pavilion
You run far this time. Past all the empty places, until you find two boys playing baseball at dusk in an empty lot.

* * *

>s
A Group of Boys
You follow the stream, walking south, until the stream becomes a river and you can no longer touch the bottom. Then you float with your eyes closed, until the river washes you up on an asphalt shore, where two boys play baseball at dusk.

You feel your time is drawing short. You won't be able to stay here long.

>s
Sandlot
You follow the stream, walking south, until the stream becomes a river and you can no longer touch the bottom. Then you float with your eyes closed, until the river washes you up on an asphalt shore, where two boys play baseball at dusk.

You feel your time is drawing short. You won't be able to stay here long.

-8

>s
There is no time. You must leave this place.

A Group of Boys
You follow the stream, walking south, until the stream becomes a river and you can no longer touch the bottom. Then you float with your eyes closed, until the river washes you up on an asphalt shore, where two boys play baseball at dusk.

You feel your time is drawing short. You won't be able to stay here long.

Sandlot
You follow the stream, walking south, until the stream becomes a river and you can no longer touch the bottom. Then you float with your eyes closed, until the river washes you up on an asphalt shore, where two boys play baseball at dusk.

You feel your time is drawing short. You won't be able to stay here long.

-9

I beg your pardon?

>s
There is no time. You must leave this place.

A Group of Boys
You follow the stream, walking south, until the stream becomes a river and you can no longer touch the bottom. Then you float with your eyes closed, until the river washes you up on an asphalt shore, where two boys play baseball at dusk.

You feel your time is drawing short. You won't be able to stay here long.

Sandlot
You follow the stream, walking south, until the stream becomes a river and you can no longer touch the bottom. Then you float with your eyes closed, until the river washes you up on an asphalt shore, where two boys play baseball at dusk.

You feel your time is drawing short. You won't be able to stay here long.

-10

>s
There is no time. You must leave this place.

A Group of Boys
You follow the stream, walking south, until the stream becomes a river and you can no longer touch the bottom. Then you float with your eyes closed, until the river washes you up on an asphalt shore, where two boys play baseball at dusk.

You feel your time is drawing short. You won't be able to stay here long.

Sandlot
You follow the stream, walking south, until the stream becomes a river and you can no longer touch the bottom. Then you float with your eyes closed, until the river washes you up on an asphalt shore, where two boys play baseball at dusk.

You feel your time is drawing short. You won't be able to stay here long.

-11

>z
There is no time. You must leave this place.

A Group of Boys
You follow the stream, walking south, until the stream becomes a river and you can no longer touch the bottom. Then you float with your eyes closed, until the river washes you up on an asphalt shore, where two boys play baseball at dusk.

You feel your time is drawing short. You won't be able to stay here long.

Time passes.

* * *

>z
Time passes.

>n
Maisan Mountain
After traveling north for some time you find yourself atop Maisain Mountain, looking out over the farmland of North Jeolla. There's a golf course down there that you might just be able to touch, as well some man-made lakes and Geum River, winding itself towards the Yellow Sea.

You could dance in the sky here, if you wanted. You could probably fly.

>n
Napo Field
You fly north until you can fly no more. Then you land here, in a middle school soccer field.

The air is cool and crisp to the touch. Autumn has come, and the birds will be here soon, stopping in this field on their way south. Or maybe they've already been.

There are some parallel bars in the distance. You could swing from those bars, or climb that barren tree. Or yoo could just keep going north.

>n
Temple Spring
You wander north for hours, searching for you don't know what. And then you find it: a fresh spring at the temple of the nirvana fish, spouting clean, cold water from a bamboo shoot.

The water flows onto a stone platform, then over the edge, and away.

You can see a cup here.

>n
Kimchi Pots
Walking north you come upon some gaint Kimchi pots.

If there was kimchi in one of those pots you could eat it... you could put it in your mouth and let the spices soak your tongue.

You could climb into one of the pots and sing until your voice was hoarse.

You could stand on top of one of them and jump up and down until someone made you stop.

You could do a million things. Or nothing at all.

>n
A Stream
You run far this time, and come upon a stream where a father plays with his two daughters.

>n
Sandlot
You follow the stream, walking north, until the stream becomes a river and you can no longer touch the bottom. Then you float with your eyes closed, until the river washes you up on an asphalt shore, where two boys play baseball at dusk.

You feel your time is drawing short. You won't be able to stay here long.

>n
A Group of Boys
You make your way qucikly north, but a group of smiling boys jumps in front of you.

"Kimchi! My name is Bae! Hello! I love you! My name is Chin-ho!"

>s
Sandlot
You follow the stream, walking south, until the stream becomes a river and you can no longer touch the bottom. Then you float with your eyes closed, until the river washes you up on an asphalt shore, where two boys play baseball at dusk.

You feel your time is drawing short. You won't be able to stay here long.

>x sdfsf
You can't see any such thing.

>z
Time passes.

>z
Time is short: you must leave this place.

>z
Time is short: you must leave this place.

>x dsfsdf
Time is short: you must leave this place.

>exit
Time is short: you must leave this place.

>n
A Group of Boys
You make your way qucikly north, but a group of smiling boys jumps in front of you.

"Kimchi! My name is Bae! Hello! I love you! My name is Chin-ho!"

>exit
There is no more time to spare: you must keep moving.

>s
Sandlot
You follow the stream, walking south, until the stream becomes a river and you can no longer touch the bottom. Then you float with your eyes closed, until the river washes you up on an asphalt shore, where two boys play baseball at dusk.

You feel your time is drawing short. You won't be able to stay here long.

>s
A Stream
You run far this time, and come upon a stream where a father plays with his two daughters.

>exit
But you aren't in anything at the moment.

* * *

>z
Time passes.

>n
There is no time. You must leave this place.

>n
There is no time. You must leave this place.

>go north
There is no time. You must leave this place.

>go
You'll have to say which compass direction to go in.

-1

* * *

>z
Time passes.

I beg your pardon?

>z
Time passes.

0

>z
There is no time. You must leave this place.

A Group of Boys
You follow the stream, walking , until the stream becomes a river and you can no longer touch the bottom. Then you float with your eyes closed, until the river washes you up on an asphalt shore, where two boys play baseball at dusk.

You feel your time is drawing short. You won't be able to stay here long.

Time passes.

>leave
But you aren't in anything at the moment.

* * *

>z
Time passes.

When you are ready to leave a location, type "go north," or "go west." Alternately you can just type "leave."

Please press SPACE to continue.

Blossom Street
A street stretches in front of you. You don't know this street, but it exists. Above you, and all around you, are cherry blossoms: they fill the street gutter; they overflow onto a yellow stripe of paint; they enter your nose, and come out your ears.

You see grass to the left. To the right is a yellow stripe, a streetlight, and a fence.

You could sit here if you wanted. You could run and dance on that yellow stripe. You could lie in the street and let the cherry blossoms burry you. If you wanted.

>z
The cherry blossoms pile higher.

>z
Time passes.

* * *

>n
Maisan Mountain
After traveling north for some time you find yourself atop Maisain Mountain, looking out over the farmland of North Jeolla. There's a golf course down there that you might just be able to touch, as well some man-made lakes and Geum River, winding itself towards the Yellow Sea.

You could dance in the sky here, if you wanted. You could probably fly.

>z
Time passes.

* * *

Being There

During the course of play you will be taken to a series of locations. In each location you can do various things by typing commands into the text prompt. Try things like:

listen
examine the stripe
touch the street
dance on the sidewalk
climb the tree
taste the flower

Please press SPACE to continue.

>s
A Stream
You run far this time, and come upon a stream where a father plays with his two daughters.

>s
Kimchi Pots
Walking south you come upon some gaint Kimchi pots.

If there was kimchi in one of those pots you could eat it... you could put it in your mouth and let the spices soak your tongue.

You could climb into one of the pots and sing until your voice was hoarse.

You could stand on top of one of them and jump up and down until someone made you stop.

You could do a million things. Or nothing at all.

>s
Temple Spring
You wander south for hours, searching for you don't know what. And then you find it: a fresh spring at the temple of the nirvana fish, spouting clean, cold water from a bamboo shoot.

The water flows onto a stone platform, then over the edge, and away.

You can see a cup here.

>n
You can't go that way.

>l
Shaded Area

* * *

>s
Temple Spring
You wander south for hours, searching for you don't know what. And then you find it: a fresh spring at the temple of the nirvana fish, spouting clean, cold water from a bamboo shoot.

The water flows onto a stone platform, then over the edge, and away.

You can see a cup here.

>s
Napo Field
You fly south until you can fly no more. Then you land here, in a middle school soccer field.

The air is cool and crisp to the touch. Autumn has come, and the birds will be here soon, stopping in this field on their way south. Or maybe they've already been.

There are some parallel bars in the distance. You could swing from those bars, or climb that barren tree. Or yoo could just keep going south.

>s
Maisan Mountain
After traveling south for some time you find yourself atop Maisain Mountain, looking out over the farmland of North Jeolla. There's a golf course down there that you might just be able to touch, as well some man-made lakes and Geum River, winding itself towards the Yellow Sea.

You could dance in the sky here, if you wanted. You could probably fly.

>s
Blossom Street
A street stretches in front of you. You don't know this street, but it exists. Above you, and all around you, are cherry blossoms: they fill the street gutter; they overflow onto a yellow stripe of paint; they enter your nose, and come out your ears.

You see grass to the left. To the right is a yellow stripe, a streetlight, and a fence.

You could sit here if you wanted. You could run and dance on that yellow stripe. You could lie in the street and let the cherry blossoms burry you. If you wanted.

>n
Maisan Mountain
After traveling north for some time you find yourself atop Maisain Mountain, looking out over the farmland of North Jeolla. There's a golf course down there that you might just be able to touch, as well some man-made lakes and Geum River, winding itself towards the Yellow Sea.

You could dance in the sky here, if you wanted. You could probably fly.

* * *

>n
Sandlot
You follow the stream, walking north, until the stream becomes a river and you can no longer touch the bottom. Then you float with your eyes closed, until the river washes you up on an asphalt shore, where two boys play baseball at dusk.

You feel your time is drawing short. You won't be able to stay here long.

>n
A Group of Boys
You follow the stream, walking north, until the stream becomes a river and you can no longer touch the bottom. Then you float with your eyes closed, until the river washes you up on an asphalt shore, where two boys play baseball at dusk.

You feel your time is drawing short. You won't be able to stay here long.

>n
A Pavilion
You run far this time. Past all the empty places, until you find two boys playing baseball at dusk in an empty lot.

>n
You take the trophy, a item of such worth that you can now return home, satisfied that you have properly plundered the temple!

    *** You return home a hero ***

Would you like to RESTART, RESTORE a saved game, or QUIT?

>n
Please give one of the answers above.

Would you like to RESTART, RESTORE a saved game, or QUIT?

>n
Please give one of the answers above.

Would you like to RESTART, RESTORE a saved game, or QUIT?

Please give one of the answers above.

Would you like to RESTART, RESTORE a saved game, or QUIT?

Please give one of the answers above.

Would you like to RESTART, RESTORE a saved game, or QUIT?

>n
Please give one of the answers above.

Would you like to RESTART, RESTORE a saved game, or QUIT?

>s
Please give one of the answers above.

Would you like to RESTART, RESTORE a saved game, or QUIT?

>s
Please give one of the answers above.

Would you like to RESTART, RESTORE a saved game, or QUIT?

>restart
Sandlot
You follow the stream, walking , until the stream becomes a river and you can no longer touch the bottom. Then you float with your eyes closed, until the river washes you up on an asphalt shore, where two boys play baseball at dusk.

You feel your time is drawing short. You won't be able to stay here long.

Sandlot
You follow the stream, walking , until the stream becomes a river and you can no longer touch the bottom. Then you float with your eyes closed, until the river washes you up on an asphalt shore, where two boys play baseball at dusk.

You feel your time is drawing short. You won't be able to stay here long.

>n
A Group of Boys
You follow the stream, walking north, until the stream becomes a river and you can no longer touch the bottom. Then you float with your eyes closed, until the river washes you up on an asphalt shore, where two boys play baseball at dusk.

You feel your time is drawing short. You won't be able to stay here long.

* * *

>s
Blossom Street
A street stretches in front of you. You don't know this street, but it exists. Above you, and all around you, are cherry blossoms: they fill the street gutter; they overflow onto a yellow stripe of paint; they enter your nose, and come out your ears.

You see grass to the left. To the right is a yellow stripe, a streetlight, and a fence.

You could sit here if you wanted. You could run and dance on that yellow stripe. You could lie in the street and let the cherry blossoms burry you. If you wanted.

>leave
Maisan Mountain
After traveling east for some time you find yourself atop Maisain Mountain, looking out over the farmland of North Jeolla. There's a golf course down there that you might just be able to touch, as well some man-made lakes and Geum River, winding itself towards the Yellow Sea.

You could dance in the sky here, if you wanted. You could probably fly.

>leave
Napo Field
You fly north until you can fly no more. Then you land here, in a middle school soccer field.

The air is cool and crisp to the touch. Autumn has come, and the birds will be here soon, stopping in this field on their way south. Or maybe they've already been.

There are some parallel bars in the distance. You could swing from those bars, or climb that barren tree. Or yoo could just keep going north.

>leave
Temple Spring
You wander south for hours, searching for you don't know what. And then you find it: a fresh spring at the temple of the nirvana fish, spouting clean, cold water from a bamboo shoot.

The water flows onto a stone platform, then over the edge, and away.

You can see a cup here.

>leave
Kimchi Pots
Walking east you come upon some gaint Kimchi pots.

If there was kimchi in one of those pots you could eat it... you could put it in your mouth and let the spices soak your tongue.

You could climb into one of the pots and sing until your voice was hoarse.

You could stand on top of one of them and jump up and down until someone made you stop.

You could do a million things. Or nothing at all.

I beg your pardon?

>n
A Stream
You run far this time, and come upon a stream where a father plays with his two daughters.

>n
Sandlot
You follow the stream, walking north, until the stream becomes a river and you can no longer touch the bottom. Then you float with your eyes closed, until the river washes you up on an asphalt shore, where two boys play baseball at dusk.

You feel your time is drawing short. You won't be able to stay here long.

2

I beg your pardon?

>n
A Group of Boys
You follow the stream, walking north, until the stream becomes a river and you can no longer touch the bottom. Then you float with your eyes closed, until the river washes you up on an asphalt shore, where two boys play baseball at dusk.

You feel your time is drawing short. You won't be able to stay here long.

* * *

>s
Kimchi Pots
Walking south you come upon some gaint Kimchi pots.

If there was kimchi in one of those pots you could eat it... you could put it in your mouth and let the spices soak your tongue.

You could climb into one of the pots and sing until your voice was hoarse.

You could stand on top of one of them and jump up and down until someone made you stop.

You could do a million things. Or nothing at all.

>w
Temple Spring
Lorem ipsum dolor sit amet, consectetur adipiscing elit. Nam aliquam ligula ac risus gravida auctor. Vestibulum ante ipsum primis in faucibus orci luctus et ultrices posuere cubilia Curae; Etiam malesuada diam et libero sagittis eget condimentum nulla interdum. Cras tincidunt molestie lorem, eu elementum elit suscipit quis. Donec sagittis, massa eget vestibulum congue, augue arcu iaculis ligula, vel pellentesque lectus magna non mauris. Nullam fermentum adipiscing posuere. Donec et neque mauris, ut mollis odio. Quisque pretium cursus elementum. Suspendisse eget turpis elementum leo semper laoreet ut a dui. Praesent facilisis, augue malesuada accumsan rhoncus, metus mi tincidunt est, eget dictum metus nibh sed velit. Cum sociis natoque penatibus et magnis dis parturient montes, nascetur ridiculus mus. Nulla aliquam, augue a vulputate hendrerit, lorem elit blandit lorem, a placerat est ante quis justo. Maecenas vitae mattis libero. Fusce et egestas augue.

>e
You can't go that way.

* * *

>s
A Stream
You run far this time, and come upon a stream where a father plays with his two daughters.

>n
Sandlot
You follow the stream, walking north, until the stream becomes a river and you can no longer touch the bottom. Then you float with your eyes closed, until the river washes you up on an asphalt shore, where two boys play baseball at dusk.

You feel your time is drawing short. You won't be able to stay here long.

2

>s
A Stream
You run far this time, and come upon a stream where a father plays with his two daughters.

>s
You can't go that way.

>s
You can't go that way.

* * *

>s
A Stream
You run far this time, and come upon a stream where a father plays with his two daughters.

>take towel
That seems to belong to the Korean man.

>n
Sandlot
You run far this time. Past all the empty places, until you find two boys playing baseball at dusk in an empty lot.

* * *

>n
Sandlot
You follow the stream, walking north, until the stream becomes a river and you can no longer touch the bottom. Then you float with your eyes closed, until the river washes you up on an asphalt shore, where two boys play baseball at dusk.

You feel your time is drawing short. You won't be able to stay here long.

2

>n
Maisain Mountain
After traveling  for some time you find yourself atop Maisain Mountain, looking out over the farmland of North Jeolla. There's a golf course down there that you might just be able to touch, as well some man-made lakes and Geum River, winding itself towards the Yellow Sea.

You could dance in the sky here, if you wanted. You could probably fly.

* * *

>n
Sandlot
You follow the stream, walking north, until the stream becomes a river and you can no longer touch the bottom. Then you float with your eyes closed, until the river washes you up on an asphalt shore, where two boys play baseball at dusk.

You feel your time is drawing short. You won't be able to stay here long.

2

>z
Time passes.

1

>z
Time passes.

0

>z
There is no time.

Time passes.

-1

>z
There is no time.

Time passes.

-2

* * *

>s
A Stream
You run far this time, and come upon a stream where a father plays with his two daughters.

>x man
A middle aged Korean man, having fun with his daughters.

* * *

Blossom Street
A street stretches in front of you. You don't know this street, but it exists. Above you, and all around you, are cherry blossoms: they fill the street gutter; they overflow onto a yellow stripe of paint; they enter your nose, and come out your ears.

You see grass to the left. To the right is a yellow stripe, a streetlight, and a fence.

You could sit here if you wanted. You could run and dance on that yellow stripe. You could lie in the street and let the cherry blossoms burry you. If you wanted.

>aplsh
That's not a verb I recognize.

>splash
You summon your strength and produce a monstrous splash.

>splash the road
You splash the road vigorously, getting wonderfully soaked in the process.

* * *

>s
A Stream
You run far this time, and come upon a stream where a father plays with his two daughters.

When you are ready to leave a location, type "go north," or "go west." Alternately you can just type "leave."

Please press SPACE to continue.

Blossom Street
A street stretches in front of you. You don't know this street, but it exists. Above you, and all around you, are cherry blossoms: they fill the street gutter; they overflow onto a yellow stripe of paint; they enter your nose, and come out your ears.

You see grass to the left. To the right is a yellow stripe, a streetlight, and a fence.

You could sit here if you wanted. You could run and dance on that yellow stripe. You could lie in the street and let the cherry blossoms bury you. If you wanted.

I beg your pardon?

* * *

Blossom Street
A street stretches in front of you. You don't know this street, but it exists. Above you, and all around you, are cherry blossoms: they fill the street gutter; they overflow onto a yellow stripe of paint; they enter your nose, and come out your ears.

You see grass to the left. To the right is a yellow stripe, a streetlight, and a fence.

You could sit here if you wanted. You could run and dance on that yellow stripe. You could lie in the street and let the cherry blossoms bury you. If you wanted.

>mile
That's not a verb I recognize.

>smile
You smile to yourself.
Above you is the sky.

>smile
You smile to yourself.
You feel a breeze behind you.

>smile
You smile to yourself.

* * *

When you are ready to leave a location, type "go north," or "go west." Alternately you can just type "leave."

Please press SPACE to continue.

* * *

Blossom Street
A street stretches in front of you. You don't know this street, but it exists. Above you, and all around you, are cherry blossoms: they fill the street gutter; they overflow onto a yellow stripe of paint; they enter your nose, and come out your ears.

You see grass to the left. To the right is a yellow stripe, a streetlight, and a fence.

You could sit here if you wanted. You could run and dance on that yellow stripe. You could lie in the street and let the cherry blossoms bury you. If you wanted.

>sdfsdfs on sidewalk
Sorry, I don't know how to sdfsdfs.

* * *

Being There

During the course of play you will be taken to a series of locations. In each location you can do various things by typing commands into the text prompt. Try things like:

listen
examine the stripe
touch the street
dance on the sidewalk
climb the tree
taste the flower

Please press SPACE to continue.

>version
Identification number: //CC6D4519-B5C3-43CC-9819-0D2CED764918//
Interpreter version 0.4.4 / VM 3.1.1 / Library serial number 080126
Standard Rules version 2/090402 by Graham Nelson
Location Images by Emily Short
Simple Graphical Window version 6 by Emily Short
Glulx Text Effects version 3 by Emily Short

* * *

Being There

During the course of play you will be taken to a series of locations. In each location you can do various things by typing commands into the text prompt. Try things like:

listen
examine the stripe
touch the street
dance on the sidewalk
climb the tree
taste the flower

Please press SPACE to continue.

>l
Sorry -- try again.
You can review your surroundings at any time by typing LOOK. Try it -- type LOOK now. (Or, if you don't need instructions, you can turn the tutorial off by typing TUTORIAL MODE OFF.)

>look
Excellent -- LOOK will print a description of your environment, like so:

Shaded Area
To move from place to place, you can use the compass directions (NORTH, SOUTH, EAST, WEST, as well as NORTHEAST, NORTHWEST, etc.) 

From here, try EAST.

* * *

>l
Sorry -- try again.
You can review your surroundings at any time by typing LOOK. Try it -- type LOOK now. (Or, if you don't need instructions, you can turn the tutorial off by typing TUTORIAL MODE OFF.)

When you are ready to leave a location, type "go north," or "go west." Alternately you can just type "leave."

Please press SPACE to continue.

* * *

Blossom Street
A street stretches in front of you. You don't know this street, but it exists. Above you, and all around you, are cherry blossoms: they fill the street gutter; they overflow onto a yellow stripe of paint; they enter your nose, and come out your ears.

You see grass to the left. To the right is a yellow stripe, a streetlight, and a fence.

You could sit here if you wanted. You could run and dance on that yellow stripe. You could lie in the street and let the cherry blossoms bury you. If you wanted.

>look through fence
Looks to be a convention center of some sort, or a hotel. You can see the hole where the pool will be.

>look through fence
Looks to be a convention center of some sort, or a hotel. You can see the hole where the pool will be.

>look over fence
Looks to be a convention center of some sort, or a hotel. You can see the hole where the pool will be.

>look over fence
Looks to be a convention center of some sort, or a hotel. You can see the hole where the pool will be.

>climb fence
You climb to the top of the fence and have a sit.

>climb light
You shimmy up the pole "till you get to the lamp, and can go no higher. You get a nice view of the construction on the other side of the fence from here.

>get on light
You shimmy up the pole "till you get to the lamp, and can go no higher. You get a nice view of the construction on the other side of the fence from here.

* * *

Blossom Street
A street stretches in front of you. You don't know this street, but it exists. Above you, and all around you, are cherry blossoms: they fill the street gutter; they overflow onto a yellow stripe of paint; they enter your nose, and come out your ears.

You see grass to the left. To the right is a yellow stripe, a streetlight, and a fence.

You could sit here if you wanted. You could run and dance on that yellow stripe. You could lie in the street and let the cherry blossoms bury you. If you wanted.

>look up
You look up into the sky, vast and sprawling above you.

* * *

Being There

During the course of play you will be taken to a series of locations. In each location you can do various things by typing commands into the text prompt. Try things like:

listen
examine the stripe
touch the street
dance on the sidewalk
climb the tree
taste the flower

Please press SPACE to continue.

>help
Whoops, that's not it.
You can review your surroundings at any time by typing LOOK. Try it -- type LOOK now. (Or, if you don't need instructions, you can turn the tutorial off by typing TUTORIAL MODE OFF.)

>t
> Introduction to Being
   Instructions for Play

>d
> Introduction to Being
   Instructions for Play

>[enter]
This is a simple demonstration  game.

Please press SPACE to continue.

> Introduction to Being
   Instructions for Play

 > Introduction to Being
   Instructions for Play

This is a simple demonstration  game.

Please press SPACE to continue.

> Introduction to Being
   Instructions for Play

 > Introduction to Being
   Instructions for Play

>q
Shaded Area

>help
> Introduction to Being
   Instructions for Play

>n
Introduction to Being
 > Instructions for Play

   Introduction to Being
 > Instructions for Play

>n
Introduction to Being
 > Instructions for Play

   Introduction to Being
 > Instructions for Play

>p
> Introduction to Being
   Instructions for Play

 > Introduction to Being
   Instructions for Play

>[enter]
This is a simple demonstration  game.

Please press SPACE to continue.

* * *

> Introduction to Being
   Instructions for Play

 > Introduction to Being
   Instructions for Play

>n
Introduction to Being
 > Instructions for Play

   Introduction to Being
 > Instructions for Play

>[enter]
> About Interactive Fiction
   What to do with >
   Getting Started
   Rooms and Travel
   Objects
   Controlling the Game
   How the World is Assembled
   If You Get Stuck

>n
About Interactive Fiction
 > What to do with >
   Getting Started
   Rooms and Travel
   Objects
   Controlling the Game
   How the World is Assembled
   If You Get Stuck

   About Interactive Fiction
 > What to do with >
   Getting Started
   Rooms and Travel
   Objects
   Controlling the Game
   How the World is Assembled
   If You Get Stuck

>n
About Interactive Fiction
   What to do with >
 > Getting Started
   Rooms and Travel
   Objects
   Controlling the Game
   How the World is Assembled
   If You Get Stuck

   About Interactive Fiction
   What to do with >
 > Getting Started
   Rooms and Travel
   Objects
   Controlling the Game
   How the World is Assembled
   If You Get Stuck

>n
About Interactive Fiction
   What to do with >
   Getting Started
 > Rooms and Travel
   Objects
   Controlling the Game
   How the World is Assembled
   If You Get Stuck

   About Interactive Fiction
   What to do with >
   Getting Started
 > Rooms and Travel
   Objects
   Controlling the Game
   How the World is Assembled
   If You Get Stuck

>n
About Interactive Fiction
   What to do with >
   Getting Started
   Rooms and Travel
 > Objects
   Controlling the Game
   How the World is Assembled
   If You Get Stuck

   About Interactive Fiction
   What to do with >
   Getting Started
   Rooms and Travel
 > Objects
   Controlling the Game
   How the World is Assembled
   If You Get Stuck

>n
About Interactive Fiction
   What to do with >
   Getting Started
   Rooms and Travel
   Objects
 > Controlling the Game
   How the World is Assembled
   If You Get Stuck

   About Interactive Fiction
   What to do with >
   Getting Started
   Rooms and Travel
   Objects
 > Controlling the Game
   How the World is Assembled
   If You Get Stuck

>n
About Interactive Fiction
   What to do with >
   Getting Started
   Rooms and Travel
   Objects
   Controlling the Game
 > How the World is Assembled
   If You Get Stuck

   About Interactive Fiction
   What to do with >
   Getting Started
   Rooms and Travel
   Objects
   Controlling the Game
 > How the World is Assembled
   If You Get Stuck

>n
About Interactive Fiction
   What to do with >
   Getting Started
   Rooms and Travel
   Objects
   Controlling the Game
   How the World is Assembled
 > If You Get Stuck

   About Interactive Fiction
   What to do with >
   Getting Started
   Rooms and Travel
   Objects
   Controlling the Game
   How the World is Assembled
 > If You Get Stuck

>n
About Interactive Fiction
   What to do with >
   Getting Started
   Rooms and Travel
   Objects
   Controlling the Game
   How the World is Assembled
 > If You Get Stuck

   About Interactive Fiction
   What to do with >
   Getting Started
   Rooms and Travel
   Objects
   Controlling the Game
   How the World is Assembled
 > If You Get Stuck

>p
About Interactive Fiction
   What to do with >
   Getting Started
   Rooms and Travel
   Objects
   Controlling the Game
 > How the World is Assembled
   If You Get Stuck

   About Interactive Fiction
   What to do with >
   Getting Started
   Rooms and Travel
   Objects
   Controlling the Game
 > How the World is Assembled
   If You Get Stuck

>p
About Interactive Fiction
   What to do with >
   Getting Started
   Rooms and Travel
   Objects
 > Controlling the Game
   How the World is Assembled
   If You Get Stuck

   About Interactive Fiction
   What to do with >
   Getting Started
   Rooms and Travel
   Objects
 > Controlling the Game
   How the World is Assembled
   If You Get Stuck

>p
About Interactive Fiction
   What to do with >
   Getting Started
   Rooms and Travel
 > Objects
   Controlling the Game
   How the World is Assembled
   If You Get Stuck

   About Interactive Fiction
   What to do with >
   Getting Started
   Rooms and Travel
 > Objects
   Controlling the Game
   How the World is Assembled
   If You Get Stuck

>p
About Interactive Fiction
   What to do with >
   Getting Started
 > Rooms and Travel
   Objects
   Controlling the Game
   How the World is Assembled
   If You Get Stuck

   About Interactive Fiction
   What to do with >
   Getting Started
 > Rooms and Travel
   Objects
   Controlling the Game
   How the World is Assembled
   If You Get Stuck

>p
About Interactive Fiction
   What to do with >
 > Getting Started
   Rooms and Travel
   Objects
   Controlling the Game
   How the World is Assembled
   If You Get Stuck

   About Interactive Fiction
   What to do with >
 > Getting Started
   Rooms and Travel
   Objects
   Controlling the Game
   How the World is Assembled
   If You Get Stuck

>p
About Interactive Fiction
 > What to do with >
   Getting Started
   Rooms and Travel
   Objects
   Controlling the Game
   How the World is Assembled
   If You Get Stuck

   About Interactive Fiction
 > What to do with >
   Getting Started
   Rooms and Travel
   Objects
   Controlling the Game
   How the World is Assembled
   If You Get Stuck

>p
> About Interactive Fiction
   What to do with >
   Getting Started
   Rooms and Travel
   Objects
   Controlling the Game
   How the World is Assembled
   If You Get Stuck

 > About Interactive Fiction
   What to do with >
   Getting Started
   Rooms and Travel
   Objects
   Controlling the Game
   How the World is Assembled
   If You Get Stuck

>p
> About Interactive Fiction
   What to do with >
   Getting Started
   Rooms and Travel
   Objects
   Controlling the Game
   How the World is Assembled
   If You Get Stuck

 > About Interactive Fiction
   What to do with >
   Getting Started
   Rooms and Travel
   Objects
   Controlling the Game
   How the World is Assembled
   If You Get Stuck

>q
Introduction to Being
 > Instructions for Play

>q
Shaded Area

* * *

>help
Whoops, that's not it.
You can review your surroundings at any time by typing LOOK. Try it -- type LOOK now. (Or, if you don't need instructions, you can turn the tutorial off by typing TUTORIAL MODE OFF.)

>look
Excellent -- LOOK will print a description of your environment, like so:

Blossom Street
A street stretches in front of you. You don't know this street, but it exists. Above you, and all around you, are cherry blossoms: they fill the street gutter; they overflow onto a yellow stripe of paint; they enter your nose, and come out your ears.

You see grass to the left. To the right is a yellow stripe, a streetlight, and a fence.

You could sit here if you wanted. You could run and dance on that yellow stripe. You could lie in the street and let the cherry blossoms burry you. If you wanted.

Individual objects have descriptions, too. You can find out more by examining them, as in EXAMINE YOUR FINGER.

>tutorial mode off
Tutorial mode is now off.

>help
> Introduction to Being
   Instructions for Play

>[down]
Introduction to Being
 > Instructions for Play

   Introduction to Being
 > Instructions for Play

>[up]
> Introduction to Being
   Instructions for Play

 > Introduction to Being
   Instructions for Play

>[down]
Introduction to Being
 > Instructions for Play

   Introduction to Being
 > Instructions for Play

* * *

>[up]
> Introduction to Being
   Instructions for Play

 > Introduction to Being
   Instructions for Play

>[enter]
This is a simple demonstration  game.

Please press SPACE to continue.

* * *

> Introduction to Being
   Instructions for Play

 > Introduction to Being
   Instructions for Play

>[down]
Introduction to Being
 > Instructions for Play

   Introduction to Being
 > Instructions for Play

>[enter]
> About Interactive Fiction
   What to do with >
   Getting Started
   Rooms and Travel
   Objects
   Controlling the Game
   How the World is Assembled
   If You Get Stuck

>[down]
About Interactive Fiction
 > What to do with >
   Getting Started
   Rooms and Travel
   Objects
   Controlling the Game
   How the World is Assembled
   If You Get Stuck

   About Interactive Fiction
 > What to do with >
   Getting Started
   Rooms and Travel
   Objects
   Controlling the Game
   How the World is Assembled
   If You Get Stuck

>[down]
About Interactive Fiction
   What to do with >
 > Getting Started
   Rooms and Travel
   Objects
   Controlling the Game
   How the World is Assembled
   If You Get Stuck

   About Interactive Fiction
   What to do with >
 > Getting Started
   Rooms and Travel
   Objects
   Controlling the Game
   How the World is Assembled
   If You Get Stuck

>[up]
About Interactive Fiction
 > What to do with >
   Getting Started
   Rooms and Travel
   Objects
   Controlling the Game
   How the World is Assembled
   If You Get Stuck

   About Interactive Fiction
 > What to do with >
   Getting Started
   Rooms and Travel
   Objects
   Controlling the Game
   How the World is Assembled
   If You Get Stuck

>[up]
> About Interactive Fiction
   What to do with >
   Getting Started
   Rooms and Travel
   Objects
   Controlling the Game
   How the World is Assembled
   If You Get Stuck

 > About Interactive Fiction
   What to do with >
   Getting Started
   Rooms and Travel
   Objects
   Controlling the Game
   How the World is Assembled
   If You Get Stuck

>[enter]
The game you are playing is a work of Interactive Fiction.  In interactive fiction you play the main character of a story.  You type commands which determine the actions of the character and the flow of the plot.  Some IF games include graphics, but most do not: the imagery is provided courtesy of your imagination.  On the other hand, there's a wide range of action available: whereas in other games you may be restricted to shooting, movement, or searching items you can click on with a mouse, IF allows you a wide range of verbs.

Please press SPACE to continue.

> About Interactive Fiction
   What to do with >
   Getting Started
   Rooms and Travel
   Objects
   Controlling the Game
   How the World is Assembled
   If You Get Stuck

 > About Interactive Fiction
   What to do with >
   Getting Started
   Rooms and Travel
   Objects
   Controlling the Game
   How the World is Assembled
   If You Get Stuck

>[down]
About Interactive Fiction
 > What to do with >
   Getting Started
   Rooms and Travel
   Objects
   Controlling the Game
   How the World is Assembled
   If You Get Stuck

   About Interactive Fiction
 > What to do with >
   Getting Started
   Rooms and Travel
   Objects
   Controlling the Game
   How the World is Assembled
   If You Get Stuck

* * *

>[up]
About Interactive Fiction
 > What to do with >
   Getting Started
   Rooms and Travel
   Objects
   Controlling the Game
   How the World is Assembled
   If You Get Stuck

   About Interactive Fiction
 > What to do with >
   Getting Started
   Rooms and Travel
   Objects
   Controlling the Game
   How the World is Assembled
   If You Get Stuck

>[enter]
The > sign is where the game says, "Okay, what do you want to do now?"  You may respond by typing an instruction -- usually an imperative verb, possibly followed by prepositions and objects.  So, for instance, LOOK, LOOK AT FISH, TAKE FISH.

Please press SPACE to continue.

About Interactive Fiction
 > What to do with >
   Getting Started
   Rooms and Travel
   Objects
   Controlling the Game
   How the World is Assembled
   If You Get Stuck

   About Interactive Fiction
 > What to do with >
   Getting Started
   Rooms and Travel
   Objects
   Controlling the Game
   How the World is Assembled
   If You Get Stuck

>[down]
About Interactive Fiction
   What to do with >
 > Getting Started
   Rooms and Travel
   Objects
   Controlling the Game
   How the World is Assembled
   If You Get Stuck

   About Interactive Fiction
   What to do with >
 > Getting Started
   Rooms and Travel
   Objects
   Controlling the Game
   How the World is Assembled
   If You Get Stuck

>[down]
About Interactive Fiction
   What to do with >
   Getting Started
 > Rooms and Travel
   Objects
   Controlling the Game
   How the World is Assembled
   If You Get Stuck

   About Interactive Fiction
   What to do with >
   Getting Started
 > Rooms and Travel
   Objects
   Controlling the Game
   How the World is Assembled
   If You Get Stuck

>[up]
About Interactive Fiction
   What to do with >
 > Getting Started
   Rooms and Travel
   Objects
   Controlling the Game
   How the World is Assembled
   If You Get Stuck

   About Interactive Fiction
   What to do with >
 > Getting Started
   Rooms and Travel
   Objects
   Controlling the Game
   How the World is Assembled
   If You Get Stuck

>[down]
About Interactive Fiction
   What to do with >
   Getting Started
 > Rooms and Travel
   Objects
   Controlling the Game
   How the World is Assembled
   If You Get Stuck

   About Interactive Fiction
   What to do with >
   Getting Started
 > Rooms and Travel
   Objects
   Controlling the Game
   How the World is Assembled
   If You Get Stuck

>[down]
About Interactive Fiction
   What to do with >
   Getting Started
   Rooms and Travel
 > Objects
   Controlling the Game
   How the World is Assembled
   If You Get Stuck

   About Interactive Fiction
   What to do with >
   Getting Started
   Rooms and Travel
 > Objects
   Controlling the Game
   How the World is Assembled
   If You Get Stuck

>[down]
About Interactive Fiction
   What to do with >
   Getting Started
   Rooms and Travel
   Objects
 > Controlling the Game
   How the World is Assembled
   If You Get Stuck

   About Interactive Fiction
   What to do with >
   Getting Started
   Rooms and Travel
   Objects
 > Controlling the Game
   How the World is Assembled
   If You Get Stuck

>[down]
About Interactive Fiction
   What to do with >
   Getting Started
   Rooms and Travel
   Objects
   Controlling the Game
 > How the World is Assembled
   If You Get Stuck

   About Interactive Fiction
   What to do with >
   Getting Started
   Rooms and Travel
   Objects
   Controlling the Game
 > How the World is Assembled
   If You Get Stuck

>[down]
About Interactive Fiction
   What to do with >
   Getting Started
   Rooms and Travel
   Objects
   Controlling the Game
   How the World is Assembled
 > If You Get Stuck

   About Interactive Fiction
   What to do with >
   Getting Started
   Rooms and Travel
   Objects
   Controlling the Game
   How the World is Assembled
 > If You Get Stuck

>[enter]
> Explore
   Read carefully
   Be creative
   Cooperate

>[down]
Explore
 > Read carefully
   Be creative
   Cooperate

   Explore
 > Read carefully
   Be creative
   Cooperate

>[up]
> Explore
   Read carefully
   Be creative
   Cooperate

 > Explore
   Read carefully
   Be creative
   Cooperate

>[enter]
Examine every object and look at everything in your inventory. Open all the doors you can find, and go through them. Look inside all closed containers. Make sure you've exhausted all the options in your environment. 

Try out all your senses. If the game mentions texture, odor, or sound, try touching, smelling, listening to, or tasting objects.

Be thorough. If you still can't figure out what to do, try opening windows, looking under beds, etc. Sometimes objects are well-hidden.

Please press SPACE to continue.

> Explore
   Read carefully
   Be creative
   Cooperate

 > Explore
   Read carefully
   Be creative
   Cooperate

* * *

Being There

During the course of play you will be taken to a series of locations. In each location you can do various things by typing commands into the text prompt. Try things like:

listen
examine the stripe
touch the street
dance on the sidewalk
climb the tree
taste the flower

Please press SPACE to continue.

>x stripe
It's a bold yellow centerline made by a striper. You could taste it if you wanted.

>l
Blossom Street
A street stretches in front of you. You don't know this street, but it exists. Above you, and all around you, are cherry blossoms: they fill the street gutter; they overflow onto a yellow stripe of paint; they enter your nose, and come out your ears.

You see grass to the left. To the right are yellow stripes, a streetlight, and a fence.

You could sit here if you wanted. You could run and dance here. You could lie in the street and let the cherry blossoms burry you. If you wanted.

>x yellow
A fine yellow stripe of paint.

>x paint
A fine yellow stripe of paint.

* * *

>x stripe
It's a bold yellow centerline made by a striper. You could taste it if you wanted.

>take stripe
That's hardly portable.

>lie on stripe
That's not a verb I recognize.

>lie down
That's not a verb I recognize.

>lay down
That's not a verb I recognize.

>sit
(on the yellow stripe of paint)
That's not something you can sit down on.

* * *

>take stripe
That's hardly portable.

>taste stripe
You taste nothing unexpected.

* * *

>x stripe
It's a bold yellow centerline made by a striper. You could taste it if you wanted.

>enter stripe
That's not something you can enter.

>dance
That's not a verb I recognize.

* * *

>x stripe
It's a bold yellow centerline made by a striper. You could taste it if you wanted.

>sit on stripe
You are now seated on the yellow stripe of paint.

>l
Blossom Street (on the yellow stripe of paint)
A street stretches in front of you. You don't know this street, but it exists. Above you, and all around you, are cherry blossoms: they fill the street gutter; they overflow onto a yellow stripe of paint; they enter your nose, and come out your ears.

You see grass to the left. To the right are yellow stripes, a streetlight, and a fence.

You could sit here if you wanted. You could run and dance on that yellow stripe. You could lie in the street and let the cherry blossoms burry you. If you wanted.

>get up
You get off the yellow stripe of paint.

Blossom Street
You can see a yellow stripe of paint here.

>sit down
You are now seated.

>get up
But you aren't in anything at the moment.

>posture
That's not a verb I recognize.

>help
That's not a verb I recognize.

>help
That's not a verb I recognize.

>sit
You are already seated.

>stand
You are now standing.

>lie down
You are now reclining.

>lie on stripe
You are now reclining on the yellow stripe of paint.

* * *

>sit on stripe
You are now seated on the yellow stripe of paint.

>x road
It's a road.

>sit on road
(getting off the yellow stripe of paint)
You can't take that position on the road.

* * *

>sit on stripe
You are now seated on the yellow stripe of paint.

>lie on stripe
You are now reclining on the yellow stripe of paint.

>get up
You get off the yellow stripe of paint.

Blossom Street

>x street
It's a road.

>x road
It's a road.

>sit on road
You can't take that position on the road.

* * *

>x stripe
It's a bold yellow centerline made by a striper. You could taste it if you wanted.

>sit stripe
I only understood you as far as wanting to sit.

>sit on stripe
You are now seated on the yellow stripe of paint.

>lie on stripe
You lie on the sweet yellow stripe
You are now reclining on the yellow stripe of paint.

* * *

>x stripe
It's a bold yellow centerline made by a striper. You could taste it if you wanted.

>taste stripe
It tastes earthy and yellow, and feels like hard paint. The blossoms are delicious.

>lie on stripe
You lie on the sweet yellow stripe
You are now reclining on the yellow stripe of paint.

* * *

>x stripe
It's a bold yellow centerline made by a striper. You could taste it if you wanted.

>red
It's a bold red centerline made by a striper. You could taste it if you wanted.

>sit on red
You can't take that position on the red stripe of paint.

>sit on yellow
(getting off the red stripe of paint)
You are now seated on the yellow stripe of paint.

* * *

Being There

During the course of play you will be taken to a series of locations. In each location you can do various things by typing commands into the text prompt. Try things like:

listen
examine the stripe
touch the street
dance on the sidewalk
climb the tree
taste the flower

Please press SPACE to continue.

>x paint
It's a bold yellow centerline made by a Striper. Minimal cracking means that it wasn't laid so long ago. Last month? Last year?

>x stripe
You can't see any such thing.

* * *

>x paint
It's a bold yellow centerline made by a Striper. Minimal cracking means that it wasn't laid so long ago. Last month? Last year?

>take paint
Taken.

* * *

>x paint
It's a bold yellow centerline made by a Striper. Minimal cracking means that it wasn't laid so long ago. Last month? Last year?

>sit on paint
That's not something you can sit down on.

>stand on paint
That's not something you can stand on.

* * *

Being There

During the course of play you will be taken to a series of locations. In each location you can do various things by typing commands into the text prompt. Try things like:

listen
examine the stripe
touch the street
dance on the sidewalk
climb the tree
taste the flower

Please press SPACE to continue.

>sit on paint
You get onto the yellow stripe of paint.

>sit in pain
You can't see any such thing.

>sit in paint
That's not something you can sit down on.

* * *

>sit on paint
You get onto the yellow stripe of paint.

>x paint
It's a bold yellow centerline made by a Striper. Minimal cracking means that it wasn't laid so long ago. Last month? Last year?

* * *

>sit on paint
You get onto the yellow stripe of paint.

>stand up
You get off the yellow stripe of paint.

Blossom Street
You can see a yellow stripe of paint here.

>enter paint
You get onto the yellow stripe of paint.

* * *

Being There

During the course of play you will be taken to a series of locations. In each location you can do various things by typing commands into the text prompt. Try things like:

listen
examine the stripe
touch the street
dance on the sidewalk
climb the tree
taste the flower

Please press SPACE to continue.

>enter paint
You sit on the paint. Yay!

>stand up
But you aren't in anything at the moment.

>sit on paint
You sit on the paint. Yay!

>stand on paint
You sit on the paint. Yay!

* * *

Being There

During the course of play you will be taken to a series of locations. In each location you can do various things by typing commands into the text prompt. Try things like:

listen
examine the stripe
touch the street
dance on the sidewalk
climb the tree
taste the flower

Please press SPACE to continue.

>sit down
You are now seated. You feel a pebble beneath your buttock.

>l
Blossom Street
A street stretches in front of you. You don't know this street, but it exists. Above you, and all around you, are cherry blossoms: they fill the street gutter; they overflow onto a yellow stripe of paint; they enter your nose, and come out your ears.

You see grass to the left. To the right are yellow stripes, a streetlight, and a fence.

You could sit here if you wanted. You could run and dance here. You could lie in the street and let the cherry blossoms burry you. If you wanted.

>get up
But you aren't in anything at the moment.

>sit down
You are already seated.

>get up
But you aren't in anything at the moment.

>lie down
You are now reclining.

>stop
That's not a verb I recognize.

* * *

>sit down
You are now seated. You feel a pebble beneath your buttock.

>dance on stripe
You are now dancing on the yellow stripe of paint.You spin and you spin, until you can't see straight.

* * *

>sit down
You are now seated. You feel a pebble beneath your buttock.

>dance
You are now dancing. You spin and you spin, until you can't see straight.

* * *

>sit down
You are now seated. You feel a pebble beneath your buttock.

>stand up
You are now standing. You feel tall.

>sit down
You are now seated.

>stand up
You are now standing. You can feel the ground through your legs.

>sit down
You are now seated. You feel a breeze behind you.

>dance on grass
You are now dancing on the grass. Life is good.

>dance on stripe
(getting off the grass)
You are now dancing on the yellow stripe of paint. You spin and you spin, until you can't see straight.

* * *

>sit down
You are now seated. You feel a pebble beneath your buttock.

>n
(first standing up)

Maisan Mountain
After traveling north for some time you find yourself atop Maisain Mountain, looking out over the farmland of North Jeolla. There's a golf course down there that you might just be able to touch, as well some man-made lakes and Geum River, winding itself towards the Yellow Sea.

You could dance in the sky here, if you wanted. You could probably fly.

>swim in river
You dive into the river and swim its full breadth a few times before getting out, and drying off.

>swim across criver
I didn't understand that sentence.

>swim across river
I didn't understand that sentence.

>swim in river
You dive into the river and swim its full breadth a few times before getting out, and drying off.

>swim river
I didn't understand that sentence.

>swim in river
You dive into the river and swim its full breadth a few times before getting out, and drying off.

>swim in lake
You can't see any such thing.

>swim in lakes
That's not something you can enter.

* * *

Being There

During the course of play you will be taken to a series of locations. In each location you can do various things by typing commands into the text prompt. Try things like:

listen
examine the stripe
touch the street
dance on the sidewalk
climb the tree
taste the flower

Please press SPACE to continue.

>x grass
It's barely spring here, and this grass hasn't yet recovered from the snow that covered it all winter.

>dance on stripe
That's not a verb I recognize.

>lie on stripe
You are now reclining on the yellow stripe of paint.

* * *

>x grass
It's barely spring here, and this grass hasn't yet recovered from the snow that covered it all winter.

>stand on grass
You are now standing on the grass.

>touch grass
You feel nothing unexpected.

* * *

Being There

During the course of play you will be taken to a series of locations. In each location you can do various things by typing commands into the text prompt. Try things like:

listen
examine the stripe
touch the street
dance on the sidewalk
climb the tree
taste the flower

Please press SPACE to continue.

>lie on stripe
You are now reclining on the yellow stripe of paint.

>lie down
You are already reclining.

>lie down
You are already reclining.

* * *

Being There

During the course of play you will be taken to a series of locations. In each location you can do various things by typing commands into the text prompt. Try things like:

listen
examine the stripe
touch the street
dance on the sidewalk
climb the tree
taste the flower

Please press SPACE to continue.

>taste stripe
It tastes earthy and yellow, and feels like hard paint. A blossom sticks to your tongue.

>taste yellow
It tastes earthy and yellow, and feels like hard paint. A blossom sticks to your tongue.

>taste paint
It tastes earthy and yellow, and feels like hard paint. A blossom sticks to your tongue.

>lie on yellow
You lie on the sweet yellow stripe
You are now reclining on the yellow stripe of paint.

>eat stripe
(first taking the yellow stripe of paint)
You'd have to get off the yellow stripe of paint first.

>get up
You get off the yellow stripe of paint.

Blossom Street

>eat stripe
(first taking the yellow stripe of paint)
That's hardly portable.

* * *

>taste stripe
It tastes earthy and yellow, and feels like hard paint. A blossom sticks to your tongue.

>listen to stripe
Sounds like every stripe you've never listened to.

* * *

>taste stripe
It tastes earthy and yellow, and feels like hard paint. A blossom sticks to your tongue.

>listen stripe
I only understood you as far as wanting to listen.

>listen to stripe
Sounds like every stripe you've never listened to.

* * *

Being There

During the course of play you will be taken to a series of locations. In each location you can do various things by typing commands into the text prompt. Try things like:

listen
examine the stripe
touch the street
dance on the sidewalk
climb the tree
taste the flower

Please press SPACE to continue.

>x yellow
You can't see any such thing.

* * *

Being There

During the course of play you will be taken to a series of locations. In each location you can do various things by typing commands into the text prompt. Try things like:

listen
examine the stripe
touch the street
dance on the sidewalk
climb the tree
taste the flower

Please press SPACE to continue.

>x the street
You can't see any such thing.

>x street
You can't see any such thing.

* * *

Being There

During the course of play you will be taken to a series of locations. In each location you can do various things by typing commands into the text prompt. Try things like:

listen
examine the stripe
touch the street
dance on the sidewalk
climb the tree
taste the flower

Please press SPACE to continue.

>x street
An aslphalt street.

>x blossom street
You can't see any such thing.

>l
Blossom Street
A street stretches in front of you. You don't know this street, but it exists. Above you, and all around you, are cherry blossoms: they fill the street gutter; they overflow onto a yellow stripe of paint; they enter your nose, and come out your ears.

You see grass to the left. To the right is a yellow stripe, a streetlight, and a fence.

You could sit here if you wanted. You could run and dance on that yellow stripe. You could lie in the street and let the cherry blossoms burry you. If you wanted.

>lie in street
You can't take that position on The Street.

>lie on street
You can't take that position on The Street.

>sit on street
You can't take that position on The Street.

>sit on spot
You can't see any such thing.

>sit on stripe
(getting off The Street)
You are now seated on the yellow stripe of paint.

>up
You'll have to get off the yellow stripe of paint first.

>get up
You get off the yellow stripe of paint.

Blossom Street

>x street
An aslphalt street.

>taste street
You taste nothing unexpected.

>sit on street
You can't take that position on The Street.

>x street-proper
An aslphalt street.

>sit on street-proper
You can't take that position on The Street.

* * *

>x street
An aslphalt street.

>x street-proper
An aslphalt street.

>x street
An aslphalt street.

>x road
You can't see any such thing.

* * *

Being There

During the course of play you will be taken to a series of locations. In each location you can do various things by typing commands into the text prompt. Try things like:

listen
examine the stripe
touch the street
dance on the sidewalk
climb the tree
taste the flower

Please press SPACE to continue.

>x road
It's a road.

>x the road
An aslphalt street.

>x a raod
You can't see any such thing.

>x a raod
You can't see any such thing.

>x a road
An aslphalt street.

* * *

>x road
It's a road.

>lie on road
You can't take that position on the road.

* * *

>x road
It's a road.

>sit on road
You are now seated on the road.

>lie on road
You are now reclining on the road.

* * *

Being There

During the course of play you will be taken to a series of locations. In each location you can do various things by typing commands into the text prompt. Try things like:

listen
examine the stripe
touch the street
dance on the sidewalk
climb the tree
taste the flower

Please press SPACE to continue.

>x sidewalk
Made of that spongy stuff that's good on your knees.

>x road
An aslphalt street.

>sit in road
You can't take that position on The street.

>stand on road
You are now standing on The street.

>lie on road
You can't take that position on The street.

>lie on stripe
(getting off The street)
You are now reclining on the yellow stripe of paint.

>lie on road
(getting off the yellow stripe of paint)
You can't take that position on The street.

* * *

>x sidewalk
Made of that spongy stuff that's good on your knees.

>x side
You can't see any such thing.

>x side walk
Made of that spongy stuff that's good on your knees.

>x path
Made of that spongy stuff that's good on your knees.

* * *

Being There

During the course of play you will be taken to a series of locations. In each location you can do various things by typing commands into the text prompt. Try things like:

listen
examine the stripe
touch the street
dance on the sidewalk
climb the tree
taste the flower

Please press SPACE to continue.

>lie on road
You lie down on your back in the middle of the street, and open your mouth. Cherry blossoms rain down like snow, and settle on your legs, your torso, your fingertips.

>stand on roa
You can't see any such thing.

>stand on street
You are now standing on The street.

>standing
That's not a verb I recognize.

>stand
You can't take that position on The street.

>lie down
You can't take that position on The street.

>get up
You get off The street.

Blossom Street

>lie down
You are now reclining.

>lie on yellow
You are now reclining on the yellow stripe of paint.

>get up
You get off the yellow stripe of paint.

Blossom Street

>x stripe
It's a bold yellow centerline made by a Striper. You could taste it if you wanted.

>x stripe
It's a bold yellow centerline made by a Striper. You could taste it if you wanted.

>taste stripe
It tastes earthy and yellow, and feels like hard paint. A blossom sticks to your tongue.

>lie on stripe
You are now reclining on the yellow stripe of paint.

* * *

>lie on road
You lie down on your back in the middle of the street, and open your mouth. Cherry blossoms rain down like snow, and settle on your legs, your torso, your fingertips.

>eat blossoms
You can't see any such thing.

* * *

>lie on road
You lie down on your back in the middle of the street, and open your mouth. Cherry blossoms rain down like snow, and settle on your legs, your torso, your fingertips.

>sit on road
You are now seated on the road. You feel a pebble beneath your buttock.

>stand up
You are now standing on the road. You feel a breeze behind you.

>sit down
You are now seated on the road. Life is good.

>sit down
You are already seated.

>lie down
You are now reclining on the road. Arms outstretched.

>throw blossom
You haven't got that.

>hit blossom
Violence isn't the answer to this one.

>kiss blossom
You can only do that to something animate.

>kick flower
That's not a verb I recognize.

>hit flower
Violence isn't the answer to this one.

>lick flower
You put a flower in your mouth. It tastes like the past.

>hit fence
Violence isn't the answer to this one.

>lie on road
You lie down on your back in the middle of the street, and open your mouth. Cherry blossoms rain down like snow, and settle on your legs, your torso, your fingertips.

>lie in road
You lie down on your back in the middle of the street, and open your mouth. Cherry blossoms rain down like snow, and settle on your legs, your torso, your fingertips.

>swim in road
You can't take that position on the road.

>n
(first leaving the road)

Maisan Mountain
After traveling north for some time you find yourself atop Maisain Mountain, looking out over the farmland of North Jeolla. There's a golf course down there that you might just be able to touch, as well some man-made lakes and Geum River, winding itself towards the Yellow Sea.

You could dance in the sky here, if you wanted. You could probably fly.

>swim in river
You dive into the river and swim its full breadth a few times before getting out, and drying off.

>swim across river
I didn't understand that sentence.

>swim on river
You dive into the river and swim its full breadth a few times before getting out, and drying off.

>swim in river
You dive into the river and swim its full breadth a few times before getting out, and drying off.

>swim under river
I didn't understand that sentence.

>x golf
Land is scare, and golf is a luxury here.

>touch golf
You stretch out a hand, and can just feel the the crisp smooth grass of a green under your fingers.

>feel golf
You stretch out a hand, and can just feel the the crisp smooth grass of a green under your fingers.

>handle golf
That's not a verb I recognize.

>take golf
That's hardly portable.

>taste golf
Pretty much what you would expect.

>feel golf
You stretch out a hand, and can just feel the the crisp smooth grass of a green under your fingers.

>taste skey
You can't see any such thing.

>taste sky
You open your mouth and breathe in deep. The sky fills your lungs.

>touch sky
It feels like your dreams.

* * *

Being There

During the course of play you will be taken to a series of locations. In each location you can do various things by typing commands into the text prompt. Try things like:

listen
examine the stripe
touch the street
dance on the sidewalk
climb the tree
taste the flower

Please press SPACE to continue.

>x raod
You can't see any such thing.

>x road
An aslphalt street.

>lie on road
You can't take that position on the the street.

* * *

Being There

During the course of play you will be taken to a series of locations. In each location you can do various things by typing commands into the text prompt. Try things like:

listen
examine the stripe
touch the street
dance on the sidewalk
climb the tree
taste the flower

Please press SPACE to continue.

>x red
It's a bold red centerline made by a striper. You could taste it if you wanted.

>sit on red
You are now seated on the red stripe of paint.

>x yellow
It's a bold yellow centerline made by a striper. You could taste it if you wanted.

>sit on yellow
(getting off the red stripe of paint)
You can't take that position on the yellow stripe of paint.

* * *

>x red
It's a bold red centerline made by a striper. You could taste it if you wanted.

>x yellow
It's a bold yellow centerline made by a striper. You could taste it if you wanted.

>sit on yellow
You can't take that position on the yellow stripe of paint.

>sit on red
(getting off the yellow stripe of paint)
You are now seated on the red stripe of paint.

>stand on yellow
(getting off the red stripe of paint)
You are now standing on the yellow stripe of paint.

>stand on red
(getting off the yellow stripe of paint)
You are now standing on the red stripe of paint.

* * *

Being There

During the course of play you will be taken to a series of locations. In each location you can do various things by typing commands into the text prompt. Try things like:

listen
examine the stripe
touch the street
dance on the sidewalk
climb the tree
taste the flower

Please press SPACE to continue.

>lie on roda
You can't see any such thing.

>lie on road
You are now reclining on the road.

* * *

Being There

During the course of play you will be taken to a series of locations. In each location you can do various things by typing commands into the text prompt. Try things like:

listen
examine the stripe
touch the street
dance on the sidewalk
climb the tree
taste the flower

Please press SPACE to continue.

>eat cake
(first taking cake)
You eat cake. Not bad.

* * *

Being There

During the course of play you will be taken to a series of locations. In each location you can do various things by typing commands into the text prompt. Try things like:

listen
examine the stripe
touch the street
dance on the sidewalk
climb the tree
taste the flower

Please press SPACE to continue.

>x blossom
The cherry blossoms are everywhere, in everything. Fluffy and white like snow, but without the cold.

>x blossom
You can't see any such thing.

>x blossoms
The cherry blossoms are everywhere, in everything. Fluffy and white like snow, but without the cold.

>x cherry
The cherry blossoms are everywhere, in everything. Fluffy and white like snow, but without the cold.

>x blossoms
The cherry blossoms are everywhere, in everything. Fluffy and white like snow, but without the cold.

>>x blossom
That's not a verb I recognize.

>x blossom
You can't see any such thing.

>x blossom
You can't see any such thing.

* * *

>x blossoms
The cherry blossoms are everywhere, in everything. Fluffy and white like snow, but without the cold.

>x blossom
You can't see any such thing.

* * *

>x blossom
The cherry blossoms are everywhere, in everything. Fluffy and white like snow, but without the cold.

>taste blossom
Tastes like your past.

>listen
You hear...
Every stripe you've never listened to.
Nature busilly going about its business.
A distant stream.
sNow.

>smell
Smells surround you...
Paint and asphalt mixed with cherry blossoms.
The grassy green odor you know so well.
Earthworms and rubber.
Perfume.
sOmething sweet and dewy.

>smell flowers
You can't see any such thing.

>smell blossoms
Smells like something sweet and dewy.

>smell blossom
Smells like something sweet and dewy.

>taste blossom
Tastes like your past.

>taste
What do you want to taste?

>the blossom
Tastes like your past.

* * *

Being There

During the course of play you will be taken to a series of locations. In each location you can do various things by typing commands into the text prompt. Try things like:

listen
examine the stripe
touch the street
dance on the sidewalk
climb the tree
taste the flower

Please press SPACE to continue.

>take rock
That's hardly portable.

>take rocks
Taken.

>x rocks
You see nothing special about many rocks.

* * *

>take rock
That's hardly portable.

>x rock
You see nothing special about the rock.

>x rocks
You can't use multiple objects with that verb.

* * *

Being There

During the course of play you will be taken to a series of locations. In each location you can do various things by typing commands into the text prompt. Try things like:

listen
examine the stripe
touch the street
dance on the sidewalk
climb the tree
taste the flower

Please press SPACE to continue.

>sit on grass
You are now seated on the grass.

>dance
That's not a verb I recognize.

>sing
Your singing is abominable.

* * *

Being There

During the course of play you will be taken to a series of locations. In each location you can do various things by typing commands into the text prompt. Try things like:

listen
examine the stripe
touch the street
dance on the sidewalk
climb the tree
taste the flower

Please press SPACE to continue.

>dance
You are now dancing. You feel a breeze behind you.

>sit
You are now seated.

* * *

>dance
You are now dancing. You feel a breeze behind you.

>g
You are already dancing.

>g
You are already dancing.

>dance on stripe
You are now dancing on the yellow stripe of paint.

>dance on road
(getting off the yellow stripe of paint)
You are now dancing on the road. You spin and you spin, until you can't see straight.

>dance
You are already dancing.

>stand
You are now standing on the road.

>dance
You are now dancing on the road. Is this what flying feels like?

* * *

>dance
You are now dancing. You feel a breeze behind you.

>stand
You are now standing. You feel tall.

>sit
You are now seated. You feel a pebble beneath your buttock.

>dance
You are now dancing. Is this what flying feels like?

>sit
You are now seated. You feel a pebble beneath your buttock.

>dance
You are now dancing. What would this feel like if you were under water?

>sit
You are now seated. Life is good.

>dance
You are now dancing. Twirling ballet style.

>sit
You are now seated. Cross-legged.

>dance
You are now dancing. Leaping wildly, like a gazelle.

>sit
You are now seated. Legs out in front of you.

>dance
You are now dancing. Your best imitation of a European folk dance. Where'd you get the clogs?

>sit
You are now seated. You rest your chin on your upraised knees.

>dance
You are now dancing. Who says you can't breakdance?

* * *

>sit
You are now seated. You feel a pebble beneath your buttock.

>stand
You are now standing. You can feel the ground through your legs.

>sit
You are now seated. Cross-legged.

>sit
You are already seated.

* * *

>actions
Actions listing on.

>dance on yello
You can't see any such thing.

>dance on yellow
[dancing on the yellow stripe of paint]
[dancing on the yellow stripe of paint - succeeded]

* * *

Being There

During the course of play you will be taken to a series of locations. In each location you can do various things by typing commands into the text prompt. Try things like:

listen
examine the stripe
touch the street
dance on the sidewalk
climb the tree
taste the flower

Please press SPACE to continue.

>dance on stripe
You are now dancing on the yellow stripe of paint.

>lie on stripe
You are now reclining on the yellow stripe of paint.

* * *

Being There

During the course of play you will be taken to a series of locations. In each location you can do various things by typing commands into the text prompt. Try things like:

listen
examine the stripe
touch the street
dance on the sidewalk
climb the tree
taste the flower

Please press SPACE to continue.

>stand on yellow
You are now standing on the yellow stripe of paint.
You feel tall.

>stand on yellow
You are now standing on the yellow stripe of paint.
You can feel the ground through your legs.

>stand on yellow
You are now standing on the yellow stripe of paint.
You feel tall.

* * *

Being There

During the course of play you will be taken to a series of locations. In each location you can do various things by typing commands into the text prompt. Try things like:

listen
examine the stripe
touch the street
dance on the sidewalk
climb the tree
taste the flower

Please press SPACE to continue.

>stand
You are already standing.

>stand on yellow
You are now standing on the yellow stripe of paint.
You feel tall.

* * *

>stand
You are already standing.

>sit down
You are now seated.You feel a breeze behind you.

>stand up
You are now standing.You feel tall.

>sit down
You are now seated.Life is good.

>stand up
You are now standing.

>sit down
You are now seated.

>stand up
You are now standing.You can feel the ground through your legs.

>stand up
You are already standing.

>stand up
You are already standing.

* * *

>stand
You are already standing.

>sit
You are now seated. You feel a pebble beneath your buttock.

>stand
You are now standing. You feel a breeze behind you.

>dance
You are now dancing. You spin and you spin, until you can't see straight.

>dance
You are already dancing.

>swim
What do you want to swim on?

>bench
You can't see any such thing.

>swim on road
You can't take that position on the road.

>sit
You are now seated on the road. Cross-legged.

>dance
You are now dancing on the road. Is this what flying feels like?

>stand
You are now standing on the road. You feel tall.

>dance
You are now dancing on the road. What would this feel like if you were under water?

>sit
You are now seated on the road. Life is good.

>dance
You are now dancing on the road. Twirling ballet style.

>sit
You are now seated on the road. Legs out in front of you.

>dance
You are now dancing on the road. Leaping wildly, like a gazelle.

>stand
You are now standing on the road. You can feel the ground through your legs.

>sit
You are now seated on the road. You rest your chin on your upraised knees.

>dance
You are now dancing on the road. The breeze ruffles your hair.

>lie
What do you want to lie on?

>road
You lie down on your back in the middle of the street, and open your mouth. Cherry blossoms rain down like snow, and settle on your legs, your torso, your fingertips.

>lie down
You are now reclining on the road. Arms outstretched.

>sit
You are now seated on the road. You stare at your toes, and wonder how they got there.

>stand
You are now standing on the road.

>n
You'll have to get off the road first.

>get up
You get off the road.

Blossom Street

* * *

Being There

During the course of play you will be taken to a series of locations. In each location you can do various things by typing commands into the text prompt. Try things like:

listen
examine the stripe
touch the street
dance on the sidewalk
climb the tree
taste the flower

Please press SPACE to continue.

>dance on street
You are now dancing on the road.
You spin and you spin, until you can't see straight.

>lie on road
You lie down on your back in the middle of the street, and open your mouth. Cherry blossoms rain down like snow, and settle on your legs, your torso, your fingertips.

* * *

Being There

During the course of play you will be taken to a series of locations. In each location you can do various things by typing commands into the text prompt. Try things like:

listen
examine the stripe
touch the street
dance on the sidewalk
climb the tree
taste the flower

Please press SPACE to continue.

>sit on stripe
You are now seated on the yellow stripe of paint.You feel a pebble beneath your buttock.

>sit down
You are already seated.

>stand up
You are now standing on the yellow stripe of paint.
You feel tall.

* * *

>sit on stripe
You are now seated on the yellow stripe of paint.You feel a pebble beneath your buttock.

>dance on stripe
You are now dancing on the yellow stripe of paint.

>dance on street
(getting off the yellow stripe of paint)
You are now dancing on the road.You spin and you spin, until you can't see straight.

>sit on grass
(getting off the road)
You are now seated on the grass.Cross-legged.

* * *

Being There

During the course of play you will be taken to a series of locations. In each location you can do various things by typing commands into the text prompt. Try things like:

listen
examine the stripe
touch the street
dance on the sidewalk
climb the tree
taste the flower

Please press SPACE to continue.

>eat stripe
(first taking the yellow stripe of paint)
That's hardly portable.

* * *

Being There

During the course of play you will be taken to a series of locations. In each location you can do various things by typing commands into the text prompt. Try things like:

listen
examine the stripe
touch the street
dance on the sidewalk
climb the tree
taste the flower

Please press SPACE to continue.

>eat yellow
It tastes earthy and yellow, and feels like hard paint. A blossom sticks to your tongue.

You feel a breeze behind you.

>eating yellow
That's not a verb I recognize.

>eat yellow
(first taking the yellow stripe of paint)
That's hardly portable.

* * *

>eat yellow
It tastes earthy and yellow, and feels like hard paint. A blossom sticks to your tongue.

You feel a breeze behind you.

>lick yellow
That's not a verb I recognize.

* * *

Being There

During the course of play you will be taken to a series of locations. In each location you can do various things by typing commands into the text prompt. Try things like:

listen
examine the stripe
touch the street
dance on the sidewalk
climb the tree
taste the flower

Please press SPACE to continue.

>lick yellow
It tastes earthy and yellow, and feels like hard paint. A blossom sticks to your tongue.

You feel a breeze behind you.

>eat blossom
You can't see any such thing.

* * *

Being There

During the course of play you will be taken to a series of locations. In each location you can do various things by typing commands into the text prompt. Try things like:

listen
examine the stripe
touch the street
dance on the sidewalk
climb the tree
taste the flower

Please press SPACE to continue.

>smell stripe
Smells like paint and asphalt mixed with cherry blossoms.

>smell
Smells surround you...
Paint and asphalt mixed with cherry blossoms.
The grassy green odor you know so well.
Earthworms and rubber.

>smell road
Smells like paint and asphalt mixed with cherry blossoms.

>taste
(the rock)
Tastes like normal.

* * *

Being There

During the course of play you will be taken to a series of locations. In each location you can do various things by typing commands into the text prompt. Try things like:

listen
examine the stripe
touch the street
dance on the sidewalk
climb the tree
taste the flower

Please press SPACE to continue.

>smell paint
like paint and asphalt mixed with cherry blossoms.

>taste paint
It tastes earthy and yellow, and feels like hard paint. A blossom sticks to your tongue.

>eat paint
It tastes earthy and yellow, and feels like hard paint. A blossom sticks to your tongue.

>listen to paint
From the yellow stripe of paint you hear like every stripe you've never listened to.

>x stripe
It's a bold yellow centerline made by a striper. You could taste it if you wanted.

>l
Blossom Street
A street stretches in front of you. You don't know this street, but it exists. Above you, and all around you, are cherry blossoms: they fill the street gutter; they overflow onto a yellow stripe of paint; they enter your nose, and come out your ears.

You see grass to the left. To the right is a yellow stripe, a streetlight, and a fence.

You could sit here if you wanted. You could run and dance on that yellow stripe. You could lie in the street and let the cherry blossoms burry you. If you wanted.

You can see fifteen rocks here.

* * *

Being There

During the course of play you will be taken to a series of locations. In each location you can do various things by typing commands into the text prompt. Try things like:

listen
examine the stripe
touch the street
dance on the sidewalk
climb the tree
taste the flower

Please press SPACE to continue.

>listen to stripe
Sounds like every stripe you've never listened to.

>z
Time passes.

>taste stripe
It tastes earthy and yellow, and feels like hard paint. A blossom sticks to your tongue.

* * *

Being There

During the course of play you will be taken to a series of locations. In each location you can do various things by typing commands into the text prompt. Try things like:

listen
examine the stripe
touch the street
dance on the sidewalk
climb the tree
taste the flower

Please press SPACE to continue.

>feel yellow
Feels like hard paint.

>touch yellow
Feels like hard paint.

>touch blossom street
You can't see any such thing.

>listen to blossom street
You can't see any such thing.

>listen
Nothing of note.

>smell
There are no unusual smells here.

>smell yellow
Smells Smells like paint and asphalt mixed with cherry blossoms.

* * *

Being There

During the course of play you will be taken to a series of locations. In each location you can do various things by typing commands into the text prompt. Try things like:

listen
examine the stripe
touch the street
dance on the sidewalk
climb the tree
taste the flower

Please press SPACE to continue.

>smell yellow
Smells like paint and asphalt mixed with cherry blossoms.

* * *

Being There

During the course of play you will be taken to a series of locations. In each location you can do various things by typing commands into the text prompt. Try things like:

listen
examine the stripe
touch the street
dance on the sidewalk
climb the tree
taste the flower

Please press SPACE to continue.

>smell
Smells surround you...
...strongly spiced cabbage.

>smell
Smells surround you...
Paint and asphalt mixed with cherry blossoms

>smell
hola, amigo, and boo

>smell
hola, amigo, and boo

* * *

>smell
Smells surround you...
Paint and asphalt mixed with cherry blossoms

>look
Blossom Street
A street stretches in front of you. You don't know this street, but it exists. Above you, and all around you, are cherry blossoms: they fill the street gutter; they overflow onto a yellow stripe of paint; they enter your nose, and come out your ears.

You see grass to the left. To the right is a yellow stripe, a streetlight, and a fence.

You could sit here if you wanted. You could run and dance on that yellow stripe. You could lie in the street and let the cherry blossoms burry you. If you wanted.

You can see fifteen rocks here.

* * *

>smell
Smells surround you...
...strongly spiced cabbage.

>list of smells
That's not a verb I recognize.

* * *

>smell
Smells surround you...
...strongly spiced cabbage.

>look
Blossom Street
A street stretches in front of you. You don't know this street, but it exists. Above you, and all around you, are cherry blossoms: they fill the street gutter; they overflow onto a yellow stripe of paint; they enter your nose, and come out your ears.

You see grass to the left. To the right is a yellow stripe, a streetlight, and a fence.

You could sit here if you wanted. You could run and dance on that yellow stripe. You could lie in the street and let the cherry blossoms burry you. If you wanted.

You can see fifteen rocks here.

>smell
Smells surround you...
Paint and asphalt mixed with cherry blossoms.

* * *

>smell
Smells surround you...
...strongly spiced cabbage.

>sit on stripe
You are now seated on the yellow stripe of paint. You feel a pebble beneath your buttock.

>eat grass
normal

* * *

>smell
Smells surround you...
...strongly spiced cabbage.

>smell grass
Smells like the grassy green odor you know so well.

>smell stripe
Smells like paint and asphalt mixed with cherry blossoms.

>smell tree
You can't see any such thing.

>liten to sidewalk
That's not a verb I recognize.

>listen to sidewalk
silence

>feel
(the rock)
normal

>listen
Nothing of note.

>taste
(the rock)
normal

* * *

>smell
Smells surround you...
...strongly spiced cabbage.

>smell street
Smells like paint and asphalt mixed with cherry blossoms.

.

>smell sidewalk
Smells like earthworms and rubber.

.

* * *

>smell
Smells surround you...
...strongly spiced cabbage.

>listen
You hear...
...every stripe you've never listened to.
...nature busilly going about its business.
...a distant stream.
...snow.
...the wind in the flowers.
...no buzzing, no flickering... just silence.
...birds and the wind in the trees.

>leave
Maisan Mountain
After traveling west for some time you find yourself atop Maisain Mountain, looking out over the farmland of North Jeolla. There's a golf course down there that you might just be able to touch, as well some man-made lakes and Geum River, winding itself towards the Yellow Sea.

You could dance in the sky here, if you wanted. You could probably fly.

>leave
Napo Field
You fly north until you can fly no more. Then you land here, in a middle school soccer field.

The air is cool and crisp to the touch. Autumn has come, and the birds will be here soon, stopping in this field on their way south. Or maybe they've already been.

There are some parallel bars in the distance. You could swing from those bars, or climb that barren tree. Or yoo could just keep going north.

* * *

>leave
Kimchi Pots
Walking east you come upon some gaint Kimchi pots.

If there was kimchi in one of those pots you could eat it... you could put it in your mouth and let the spices soak your tongue.

You could climb into one of the pots and sing until your voice was hoarse.

You could stand on top of one of them and jump up and down until someone made you stop.

You could do a million things. Or nothing at all.

>leave
A Stream
You run far this time, and come upon a stream where a father plays with his two daughters.

>leave
Sandlot
You follow the stream, walking north, until the stream becomes a river and you can no longer touch the bottom. Then you float with your eyes closed, until the river washes you up on an asphalt shore, where two boys play baseball at dusk.

You feel your time is drawing short. You won't be able to stay here long.

>leave
A Group of Boys
You make your way qucikly south, but a group of smiling boys jumps in front of you.

"Kimchi! My name is Bae! Hello! I love you! My name is Chin-ho!"

>leave
A Pavilion
You manage to break away from the group of boys. Running now, panting, you've hardly any time left. Glancing to your right, you see a man helping a yong boy take off his shoes before entering a pavilion.

>leave
There is no time. You must leave this place.

Leaving
You're flying now, faster than you've ever flown before... the air that streams by you feels like a thick liquid. Glancing over your shoulder, your last glimpse of Korea is a girl in red stripes, holding an umbrella.

And then she's gone.

    *** Being There. A notgame for Korea created by Jordan Magnuson. ***

Would you like to RESTART, RESTORE a saved game, or QUIT?

* * *

>smell
Smells surround you...
...strongly spiced cabbage.

>smell kimcih
You can't see any such thing.

>smell kimchi
The kimchi is (presumably) inside of those closed pots.

>open kimchi
The kimchi is (presumably) inside of those closed pots.

>open pot
You open a kimchi pot, revealing more kimchi than you know what to do with.

>smell kimchi
Smells like strongly spiced cabbage.

* * *

Being There

During the course of play you will be taken to a series of locations. In each location you can do various things by typing commands into the text prompt. Try things like:

listen
examine the stripe
touch the street
dance on the sidewalk
climb the tree
taste the flower

Please press SPACE to continue.

>look
Excellent -- LOOK will print a description of your environment, like so:

Blossom Street
A street stretches in front of you. You don't know this street, but it exists. Above you, and all around you, are cherry blossoms: they fill the street gutter; they overflow onto a yellow stripe of paint; they enter your nose, and come out your ears.

You see grass to the left. To the right is a yellow stripe, a streetlight, and a fence.

You could sit here if you wanted. You could run and dance on that yellow stripe. You could lie in the street and let the cherry blossoms burry you. If you wanted.

Individual objects have descriptions, too. You can find out more by examining them, as in EXAMINE THE GROUND.

>smell
Smells surround you...
paint and asphalt mixed with cherry blossoms.

* * *

>examine the ground
Very good. Since you're likely to examine things frequently, you can also abbreviate this command as X, as in X your feet.

It's the ground.

You can pick things up when you see them, like this: TAKE YOUR NOSE.

>take your nose
Well done. Now you'll get a message to tell you whether you succeeded in picking up the ground:

You can't see any such thing.

To move from place to place, you can use the compass directions (NORTH, SOUTH, EAST, WEST, as well as NORTHEAST, NORTHWEST, etc.) 

From here, try NORTH.

>north
Good! Like other often-used instructions, compass directions can be abbreviated down to N, S, E, W, NE, NW, and so on. UP and DOWN are also possible -- keep an eye on room descriptions in order to learn more about where you can go and when. 

As soon as you enter a new room, you'll get a description of what's there, like this:

Maisan Mountain
After traveling north for some time you find yourself atop Maisain Mountain, looking out over the farmland of North Jeolla. There's a golf course down there that you might just be able to touch, as well some man-made lakes and Geum River, winding itself towards the Yellow Sea.

You could dance in the sky here, if you wanted. You could probably fly.

And that covers most of what you need to know! There are lots of other verbs you can type as you go along, but you'll likely be able to guess them from context. Don't be afraid to experiment with new actions.

To stop the game, type QUIT; to save your current position, type SAVE. RESTORE allows you to bring back a game you have previously saved, and RESTART starts the game over again at the beginning.

>quit
Are you sure you want to quit?

* * *

Being There

During the course of play you will be taken to a series of locations. In each location you can do various things by typing commands into the text prompt. Try things like:

listen
examine the stripe
touch the street
dance on the sidewalk
climb the tree
taste the flower

Please press SPACE to continue.

>listen to sidewalk
Silence.

>listen
Nothing of note.

>listen to stripe
Sounds every stripe you've never listened to

>listen to road
Sounds

>taste road
Tastes earthy and yellow, and feels like hard paint. A blossom sticks to your tongue

>listen
Nothing of note.

>smell
Smells surround you...
Paint and asphalt mixed with cherry blossoms.
The grassy green odor you know so well.
Earthworms and rubber.

* * *

Being There

During the course of play you will be taken to a series of locations. In each location you can do various things by typing commands into the text prompt. Try things like:

listen
examine the stripe
touch the street
dance on the sidewalk
climb the tree
taste the flower

Please press SPACE to continue.

>taste
(the rock)
Pretty much what you would expect.

>taste
(the rock)
Tastes like normal.

>taste the room
You can't see any such thing.

>taste
(the rock)
Tastes like normal.

* * *

>taste
(the rock)
Pretty much what you would expect.

>touch yellow
Feels like hard paint.

>touch rock
Feels like normal.

* * *

>taste
(the rock)
Pretty much what you would expect.

>taste the air
You can't see any such thing.

>dance on the road
You are now dancing on the road. You feel a breeze behind you.

>dance on the grass
(getting off the road)
You are now dancing on the grass. You spin and you spin, until you can't see straight.

* * *

>taste
(the rock)
Pretty much what you would expect.

>rules
Rules tracing now switched on. Type "rules off" to switch it off again, or "rules all" to include even rules which do not apply.

>taste
(the rock)
[Rule "Carry out tasting something" applies.]
Pretty much what you would expect.

* * *

>rules
Rules tracing now switched on. Type "rules off" to switch it off again, or "rules all" to include even rules which do not apply.

>actions
Actions listing on.

>taste
(the rock)
[tasting the rock]
[Rule "Carry out tasting something" applies.]
Pretty much what you would expect.

[tasting the rock - succeeded]

* * *

Being There

During the course of play you will be taken to a series of locations. In each location you can do various things by typing commands into the text prompt. Try things like:

listen
examine the stripe
touch the street
dance on the sidewalk
climb the tree
taste the flower

Please press SPACE to continue.

>feel rock
Pretty much what you would expect.

>taste
(the rock)
Pretty much what you would expect.

* * *

Being There

During the course of play you will be taken to a series of locations. In each location you can do various things by typing commands into the text prompt. Try things like:

listen
examine the stripe
touch the street
dance on the sidewalk
climb the tree
taste the flower

Please press SPACE to continue.

>listen
You hear...
Every stripe you've never listened to.
Nature busilly going about its business.

* * *

Being There

During the course of play you will be taken to a series of locations. In each location you can do various things by typing commands into the text prompt. Try things like:

listen
examine the stripe
touch the street
dance on the sidewalk
climb the tree
taste the flower

Please press SPACE to continue.

>x rocks
You see nothing special about There rocks.

* * *

Being There

During the course of play you will be taken to a series of locations. In each location you can do various things by typing commands into the text prompt. Try things like:

listen
examine the stripe
touch the street
dance on the sidewalk
climb the tree
taste the flower

Please press SPACE to continue.

>x cherry
Which do you mean, the cherry blossoms, or the cherry blossom trees?

>x blossoms
The cherry blossoms are everywhere, in everything. Fluffy and white like snow, but without the cold.

>x cherry blossoms
The cherry blossoms are everywhere, in everything. Fluffy and white like snow, but without the cold.

* * *

>x cherry
Which do you mean, the cherry blossoms, or the cherry blossom trees?

>trees
The indigenous cherry blossom trees bloom once a year in Korea, and only for a week.

>x blossom
Which do you mean, the cherry blossoms, or the cherry blossom trees?

>x flowers
The cherry blossoms are everywhere, in everything. Fluffy and white like snow, but without the cold.

>n
Maisan Mountain
After traveling north for some time you find yourself atop Maisain Mountain, looking out over the farmland of North Jeolla. There's a golf course down there that you might just be able to touch, as well some man-made lakes and Geum River, winding itself towards the Yellow Sea.

You could dance in the sky here, if you wanted. You could probably fly.

>x lake
Irrigation is what it's all about in these plains.

>n
Napo Field
You fly north until you can fly no more. Then you land here, in a middle school soccer field.

The air is cool and crisp to the touch. Autumn has come, and the birds will be here soon, stopping in this field on their way south. Or maybe they've already been.

There are some parallel bars in the distance. You could swing from those bars, or climb that barren tree. Or yoo could just keep going north.

>swing on bars
You swing around and around and around.

>swing on fiedl
You can't see any such thing.

>swing on field
You can't really swing on that.

>climb trees
You climb to the top of the barren tree. The field looks distant, and small.

>x middle school field
You see nothing special about the middle school soccer field.

>x football field
You see nothing special about the middle school soccer field.

>x gras
You can't see any such thing.

>s
Maisan Mountain
After traveling south for some time you find yourself atop Maisain Mountain, looking out over the farmland of North Jeolla. There's a golf course down there that you might just be able to touch, as well some man-made lakes and Geum River, winding itself towards the Yellow Sea.

You could dance in the sky here, if you wanted. You could probably fly.

>x
What do you want to examine?

>s
You see nothing unexpected in that direction.

>s
Blossom Street
A street stretches in front of you. You don't know this street, but it exists. Above you, and all around you, are cherry blossoms: they fill the street gutter; they overflow onto a yellow stripe of paint; they enter your nose, and come out your ears.

You see grass to the left. To the right is a yellow stripe, a streetlight, and a fence.

You could sit here if you wanted. You could run and dance on that yellow stripe. You could lie in the street and let the cherry blossoms burry you. If you wanted.

>x grass
Among the most versatile of life forms. This patch is soft and green.

>n
Maisan Mountain
After traveling north for some time you find yourself atop Maisain Mountain, looking out over the farmland of North Jeolla. There's a golf course down there that you might just be able to touch, as well some man-made lakes and Geum River, winding itself towards the Yellow Sea.

You could dance in the sky here, if you wanted. You could probably fly.

* * *

>n
Napo Field
You fly north until you can fly no more. Then you land here, in a middle school soccer field.

The air is cool and crisp to the touch. Autumn has come, and the birds will be here soon, stopping in this field on their way south. Or maybe they've already been.

There are some parallel bars in the distance. You could swing from those bars, or climb that barren tree. Or yoo could just keep going north.

>x grass
You see nothing special about the middle school soccer field.

>x field
You see nothing special about the middle school soccer field.

* * *

Being There

During the course of play you will be taken to a series of locations. In each location you can do various things by typing commands into the text prompt. Try things like:

listen
examine the stripe
touch the street
dance on the sidewalk
climb the tree
taste the flower

Please press SPACE to continue.

>x trees
These indigenous trees bloom once a year in Korea, and only for a week.

>x tree
You can't see any such thing.

* * *

Being There

During the course of play you will be taken to a series of locations. In each location you can do various things by typing commands into the text prompt. Try things like:

listen
examine the stripe
touch the street
dance on the sidewalk
climb the tree
taste the flower

Please press SPACE to continue.

>x tree
The indigenous cherry blossom trees bloom once a year in Korea, and only for a week.

>x blossom
You can't see any such thing.

* * *

>x blossoms
The cherry blossoms are everywhere, in everything. Fluffy and white like snow, but without the cold.

>take blossoms
That's hardly portable.

* * *

Being There

During the course of play you will be taken to a series of locations. In each location you can do various things by typing commands into the text prompt. Try things like:

listen
examine the stripe
touch the street
dance on the sidewalk
climb the tree
taste the flower

Please press SPACE to continue.

>take blossoms
There are too many to carry.

>take blossom
There are too many to carry.

* * *

Being There

During the course of play you will be taken to a series of locations. In each location you can do various things by typing commands into the text prompt. Try things like:

listen
examine the stripe
touch the street
dance on the sidewalk
climb the tree
taste the flower

Please press SPACE to continue.

>x gutter
It's a gutter like any other, but filled with cherry blossoms.

>stand in gutter
You are now standing in the gutter. You feel tall.

>lie down
You can't take that position in the gutter.

>sit down
You can't take that position in the gutter.

* * *

Being There

During the course of play you will be taken to a series of locations. In each location you can do various things by typing commands into the text prompt. Try things like:

listen
examine the stripe
touch the street
dance on the sidewalk
climb the tree
taste the flower

Please press SPACE to continue.

>sit in gutter
You are now seated in the gutter. You feel a pebble beneath your buttock.

>x streetlight
You can't see any such thing.

>x light
You can't see any such thing.

* * *

Being There

During the course of play you will be taken to a series of locations. In each location you can do various things by typing commands into the text prompt. Try things like:

listen
examine the stripe
touch the street
dance on the sidewalk
climb the tree
taste the flower

Please press SPACE to continue.

>x lamp
It's used to light the way for pedestrians out after dark.

>smell
Smells surround you...
Paint and asphalt mixed with cherry blossoms.
The grassy green odor you know so well.
Earthworms and rubber.

>smell lamp
Smells like normal.

>touch lamp
Pretty much what you would expect.

>sing
Your singing is abominable.

* * *

Being There

During the course of play you will be taken to a series of locations. In each location you can do various things by typing commands into the text prompt. Try things like:

listen
examine the stripe
touch the street
dance on the sidewalk
climb the tree
taste the flower

Please press SPACE to continue.

>feel stripe
Feels like You slide a finger along the yellow stripe... it leaves a line through the blossoms..

>jump
You jump on the spot, fruitlessly.

* * *

Being There

During the course of play you will be taken to a series of locations. In each location you can do various things by typing commands into the text prompt. Try things like:

listen
examine the stripe
touch the street
dance on the sidewalk
climb the tree
taste the flower

Please press SPACE to continue.

>jump
You jump on the spot, fruitlessly.

>sit down
You are now seated. You feel a pebble beneath your buttock.

>sit down
You are already seated.

* * *

>jump
You jump on the spot, fruitlessly.

>jump
You jump on the spot, fruitlessly.

>jump
You jump on the spot.

>jump
You jump on the spot. The breeze ruffles your hair.

>jump
You jump on the spot.

>jump
You jump on the spot.

>jump
You jump on the spot. A bird flies by, and looks at you.

>taste flowers
Tastes like You put a flower in your mouth. It tastes like the past..

* * *

>jump
You jump on the spot, fruitlessly.

>jump on pot
You are now jumping on a closed kimchi pot. 

You jump up and down like a maniac on the ceramic lid of a kimchi pot. You better hope it doesn't break under you!

>jump
You jump on the spot, fruitlessly.

>n
(first leaving the closed kimchi pot)

A Stream
You run far this time, and come upon a stream where a father plays with his two daughters.

>n
Sandlot
You follow the stream, walking north, until the stream becomes a river and you can no longer touch the bottom. Then you float with your eyes closed, until the river washes you up on an asphalt shore, where two boys play baseball at dusk.

You feel your time is drawing short. You won't be able to stay here long.

>jump
You jump on the spot, fruitlessly.

>jump on grass
You can't take that position on the dry grass.

>jump on grass
You can't take that position on the dry grass.

>eat grass
Tastes like the earth.

>eat asphalt
Tastes like dust and black tar.

* * *

Being There

During the course of play you will be taken to a series of locations. In each location you can do various things by typing commands into the text prompt. Try things like:

listen
examine the stripe
touch the street
dance on the sidewalk
climb the tree
taste the flower

Please press SPACE to continue.

>tastes flowers
That's not a verb I recognize.

>taste flowers
You put a flower in your mouth. It tastes like the past..

* * *

Being There

During the course of play you will be taken to a series of locations. In each location you can do various things by typing commands into the text prompt. Try things like:

listen
examine the stripe
touch the street
dance on the sidewalk
climb the tree
taste the flower

Please press SPACE to continue.

>taste flowers
You put a flower in your mouth. It tastes like the past.

>take flower
There are too many to carry.

>x flowers
The cherry blossoms are everywhere, in everything. Fluffy and white like snow, but without the cold.

>x trnk
You can't see any such thing.

>x trunk
The indigenous cherry blossom trees bloom once a year in Korea, and only for a week.

>x fence
It's a construction fence, with mountains on it.

>taste fence
Pretty much what you would expect.

>smell fence
Smells the same as it did yesterday.

>dance on fence
That's not something you can enter.

>sit on fence
That's not something you can sit down on.

>stand on fence
That's not something you can stand on.

* * *

Being There

During the course of play you will be taken to a series of locations. In each location you can do various things by typing commands into the text prompt. Try things like:

listen
examine the stripe
touch the street
dance on the sidewalk
climb the tree
taste the flower

Please press SPACE to continue.

>dance on fence
That's not something you can enter.

* * *

Being There

During the course of play you will be taken to a series of locations. In each location you can do various things by typing commands into the text prompt. Try things like:

listen
examine the stripe
touch the street
dance on the sidewalk
climb the tree
taste the flower

Please press SPACE to continue.

>n
Sandlot
You follow the stream, walking north, until the stream becomes a river and you can no longer touch the bottom. Then you float with your eyes closed, until the river washes you up on an asphalt shore, where two boys play baseball at dusk.

You feel your time is drawing short. You won't be able to stay here long.

>s
Sandlot
You follow the stream, walking south, until the stream becomes a river and you can no longer touch the bottom. Then you float with your eyes closed, until the river washes you up on an asphalt shore, where two boys play baseball at dusk.

You feel your time is drawing short. You won't be able to stay here long.

>n
Maisain Mountain

* * *

>s
Sandlot
You follow the stream, walking south, until the stream becomes a river and you can no longer touch the bottom. Then you float with your eyes closed, until the river washes you up on an asphalt shore, where two boys play baseball at dusk.

You feel your time is drawing short. You won't be able to stay here long.

>z
Time passes.

>z
There is no time. You must leave this place.

Time passes.

>z
There is no time. You must leave this place.

Time passes.

>n
There is no time. You must leave this place.

A Group of Boys
You make your way qucikly north, but a group of smiling boys jumps in front of you.

"Kimchi! My name is Bae! Hello! I love you! My name is Chin Ho!"

>z
There is no time. You must leave this place.

Time passes.

>n
There is no time. You must leave this place.

A Pavilion
You manage to break away from the group of boys. Running now, panting, you've hardly any time left. Glancing to your right, you see a man helping a yong boy take off his shoes before entering a pavilion.

>n
Leaving
You're flying now, faster than you've ever flown before... the air that streams by you feels like a thick liquid. Glancing over your shoulder, your last glimpse of Korea is a girl in red stripes, holding an umbrella.

    *** Being There. A notgame for Korea created by Jordan Magnuson. ***

Would you like to RESTART, RESTORE a saved game, or QUIT?

>s
Please give one of the answers above.

Would you like to RESTART, RESTORE a saved game, or QUIT?

* * *

>n
A Group of Boys
You make your way qucikly north, but a group of smiling boys jumps in front of you.

"Kimchi! My name is Bae! Hello! I love you! My name is Chin Ho!"

>n
A Pavilion
You manage to break away from the group of boys. Running now, panting, you've hardly any time left. Glancing to your right, you see a man helping a yong boy take off his shoes before entering a pavilion.

>n
Leaving
You're flying now, faster than you've ever flown before... the air that streams by you feels like a thick liquid. Glancing over your shoulder, your last glimpse of Korea is a girl in red stripes, holding an umbrella.

    *** Being There. A notgame for Korea created by Jordan Magnuson. ***

Would you like to RESTART, RESTORE a saved game, or QUIT?

* * *

>n
Sandlot
You follow the stream, walking north, until the stream becomes a river and you can no longer touch the bottom. Then you float with your eyes closed, until the river washes you up on an asphalt shore, where two boys play baseball at dusk.

You feel your time is drawing short. You won't be able to stay here long.

>n
A Group of Boys
You make your way quickly north, but a group of smiling boys jumps in front of you.

"Kimchi! My name is Bae! Hello! I love you! My name is Chin-ho!"

>n
Temple Spring
You wander north for hours, searching for you don't know what. And then you find it: a fresh spring at the temple of the nirvana fish, spouting clean, cold water from a bamboo shoot.

The water flows onto a stone platform, then over the edge, and away.

You can see a cup here.

* * *

>n
Kimchi Pots
Walking north you come upon some gaint Kimchi pots.

If there was kimchi in one of those pots you could eat it... you could put it in your mouth and let the spices soak your tongue.

You could climb into one of the pots and sing until your voice was hoarse.

You could stand on top of one of them and jump up and down until someone made you stop.

You could do a million things. Or nothing at all.

>s
Maisain Mountain

>s
Blossom Street

>s
You can't go that way.

>n
Maisain Mountain

>w
You can't go that way.

>n
Maisan Mountain

>s
Maisain Mountain

* * *

>n
A Stream
You run far this time, and come upon a stream where a father plays with his two daughters.

>s
Kimchi Pots
Walking south you come upon some gaint Kimchi pots.

If there was kimchi in one of those pots you could eat it... you could put it in your mouth and let the spices soak your tongue.

You could climb into one of the pots and sing until your voice was hoarse.

You could stand on top of one of them and jump up and down until someone made you stop.

You could do a million things. Or nothing at all.

>s
Napo Field
You fly south until you can fly no more. Then you land here, in a middle school soccer field.

The air is cool and crisp to the touch. Autumn has come, and the birds will be here soon, stopping over on their way south. Or maybe they've already left.

There are some parallel bars in the distance. You could sing on the field, or dance on those bars, or climb that barren tree. Or yoo could just keep going south.

>n
Maisain Mountain

>z
Time passes.

>s
Blossom Street

>n
Maisain Mountain

>s
Blossom Street

* * *

>s
Napo Field
You fly south until you can fly no more. Then you land here, in a middle school soccer field.

The air is cool and crisp to the touch. Autumn has come, and the birds will be here soon, stopping over on their way south. Or maybe they've already left.

There are some parallel bars in the distance. You could sing on the field, or dance on those bars, or climb that barren tree. Or yoo could just keep going south.

>s
Maisan Mountain
After traveling south for some time you find yourself atop Maisain Mountain, looking out over the farmland of North Jeolla. There's a golf course down there that you might just be able to touch, as well some man-made lakes and Geum River, winding itself towards the Yellow Sea.

You could dance in the sky here, if you wanted. You could probably fly.

>n
Napo Field
You fly north until you can fly no more. Then you land here, in a middle school soccer field.

The air is cool and crisp to the touch. Autumn has come, and the birds will be here soon, stopping over on their way south. Or maybe they've already left.

There are some parallel bars in the distance. You could sing on the field, or dance on those bars, or climb that barren tree. Or yoo could just keep going north.

>n
Temple Spring
You wander north for hours, searching for you don't know what. And then you find it: a fresh spring at the temple of the nirvana fish, spouting clean, cold water from a bamboo shoot.

>n
Kimchi Pots
Walking north you come upon some gaint Kimchi pots.

If there was kimchi in one of those pots you could eat it... you could put it in your mouth and let the spices soak your tongue.

You could climb into one of the pots and sing until your voice was hoarse.

You could stand on top of one of them and jump up and down until somebody made you stop.

You could do a million things. Or nothing at all.

>s
Temple Spring
You wander south for hours, searching for you don't know what. And then you find it: a fresh spring at the temple of the nirvana fish, spouting clean, cold water from a bamboo shoot.

>s
Napo Field
You fly south until you can fly no more. Then you land here, in a middle school soccer field.

The air is cool and crisp to the touch. Autumn has come, and the birds will be here soon, stopping over on their way south. Or maybe they've already left.

There are some parallel bars in the distance. You could sing on the field, or dance on those bars, or climb that barren tree. Or yoo could just keep going south.

* * *

>n
Maisan Mountain
After traveling north for some time you find yourself atop Maisain Mountain, looking out over the farmland of North Jeolla. There's a golf course down there that you might just be able to touch, as well some man-made lakes and Geum River, winding itself towards the Yellow Sea.

You could dance in the sky here, if you wanted. You could probably fly.

>n
Napo Field
You fly north until you can fly no more. Then you land here, in a middle school soccer field.

The air is cool and crisp to the touch. Autumn has come, and the birds will be here soon, stopping over on their way south. Or maybe they've already left.

There are some parallel bars in the distance. You could sing on the field, or dance on those bars, or climb that barren tree. Or yoo could just keep going north.

* * *

>s
Kimchi Pots
Walking south you come upon some gaint Kimchi pots.

If there was kimchi in one of those pots you could eat it... you could put it in your mouth and let the spices soak your tongue.

You could climb into one of the pots and sing until your voice was hoarse.

You could stand on top of one of them and jump up and down until someone made you stop.

You could do a million things. Or nothing at all.

>dance on pot
You are now dancing on a closed kimchi pot. You spin and you spin, until you can't see straight.

>x ground
You can't see any such thing.

* * *

>open pot
That's already open.

* * *

>n
A Group of Boys
You make your way qucikly north, but a group of smiling boys jumps in front of you.

"Kimchi! My name is Bae! Hello! I love you! My name is Chin-ho!"

>n
A Pavilion
You run far this time. Past all the empty places, until you find two boys playing baseball at dusk in an empty lot.

>directions
That's not a verb I recognize.

* * *

>s
Please give one of the answers above.

Would you like to RESTART, RESTORE a saved game, or QUIT?

>s
A Group of Boys
You run far this time. Past all the empty places, until you find two boys playing baseball at dusk in an empty lot.

>s
Sandlot
You run far this time. Past all the empty places, until you find two boys playing baseball at dusk in an empty lot.

>s
A Stream
You run far this time, and come upon a stream where a father plays with his daughters.

>s
Kimchi Pots
Walking south you come upon some gaint Kimchi pots.

If there was kimchi in one of those pots you could eat it... you could put it in your mouth and let the spices soak your tongue.

You could climb into one of the pots and sing until your voice was hoarse.

You could stand on top of one of them and jump up and down until someone made you stop.

You could do a million things. Or nothing at all.

>s
Temple Spring
You wander south for hours, searching for you don't know what. And then you find it: a fresh spring at the temple of the nirvana fish, spouting clean, cold water from a bamboo shoot.

>s
Napo Field
You fly south until you can fly no more. Then you land here, in a middle school soccer field.

The air is cool and crisp to the touch. Autumn has come, and the birds will be here soon, stopping in this field on their way south. Or maybe they've already been.

There are some parallel bars in the distance. You could swing from those bars, or climb that barren tree. Or yoo could just keep going south.

>n
Temple Spring
You wander north for hours, searching for you don't know what. And then you find it: a fresh spring at the temple of the nirvana fish, spouting clean, cold water from a bamboo shoot.

>n
Kimchi Pots
Walking north you come upon some gaint Kimchi pots.

If there was kimchi in one of those pots you could eat it... you could put it in your mouth and let the spices soak your tongue.

You could climb into one of the pots and sing until your voice was hoarse.

You could stand on top of one of them and jump up and down until someone made you stop.

You could do a million things. Or nothing at all.

>n
A Stream
You run far this time, and come upon a stream where a father plays with his daughters.

>n
Sandlot
You run far this time. Past all the empty places, until you find two boys playing baseball at dusk in an empty lot.

>n
A Group of Boys
You run far this time. Past all the empty places, until you find two boys playing baseball at dusk in an empty lot.

>n
A Pavilion
You run far this time. Past all the empty places, until you find two boys playing baseball at dusk in an empty lot.

>n
A Place
You run far this time. Past all the empty places, until you find two boys playing baseball at dusk in an empty lot.

>s
A Pavilion
You run far this time. Past all the empty places, until you find two boys playing baseball at dusk in an empty lot.

>s
A Group of Boys
You run far this time. Past all the empty places, until you find two boys playing baseball at dusk in an empty lot.

>n
A Pavilion
You run far this time. Past all the empty places, until you find two boys playing baseball at dusk in an empty lot.

* * *

>n
A Group of Boys
You make your way qucikly north, but a group of smiling boys jumps in front of you.

"Kimchi! My name is Bae! Hello! I love you! My name is Chin-ho!"

I beg your pardon?

I beg your pardon?

>n
You can't go that way.

I beg your pardon?

>z
There is no time. You must leave this place.

>leave
A Group of Boys
You make your way qucikly east, but a group of smiling boys jumps in front of you.

"Kimchi! My name is Bae! Hello! I love you! My name is Chin-ho!"

* * *

>n
Sandlot
You follow the stream, walking north, until the stream becomes a river and you can no longer touch the bottom. Then you float with your eyes closed, until the river washes you up on an asphalt shore, where two boys play baseball at dusk.

You feel your time is drawing short. You won't be able to stay here long.

>z
Time passes.

* * *

>z
There is no time. You must leave this place.

>x boy
There is no time. You must leave this place.

>leave
There is no time. You must leave this place.

* * *

>z
Time passes.

>x boys
Two boys taking part in one of Korea's favorite pastimes.

>talk to boys
Time is short: you must leave this place.

>x bat
Time is short: you must leave this place.

>leave
A Group of Boys
You make your way qucikly south, but a group of smiling boys jumps in front of you.

"Kimchi! My name is Bae! Hello! I love you! My name is Chin-ho!"

>say hello
(addressing the boys)
"Annyeonghaseyo!" yell the boys in unison. One of them is jumping uncontrollably.

>x boy
There is no more time to spare: you must keep moving.

>n
There is no more time to spare: you must keep moving.

A Pavilion
You manage to break away from the group of boys. Running now, panting, you've hardly any time left. Glancing to your right, you see a man helping a yong boy take off his shoes before entering a pavilion.

>s
A Group of Boys
You make your way qucikly south, but a group of smiling boys jumps in front of you.

"Kimchi! My name is Bae! Hello! I love you! My name is Chin-ho!"

>n
There is no more time to spare: you must keep moving.

A Pavilion
You manage to break away from the group of boys. Running now, panting, you've hardly any time left. Glancing to your right, you see a man helping a yong boy take off his shoes before entering a pavilion.

* * *

>s
A Group of Boys
You make your way qucikly south, but a group of smiling boys jumps in front of you.

"Kimchi! My name is Bae! Hello! I love you! My name is Chin-ho!"

>s
There is no more time to spare: you must keep moving.

Sandlot
You follow the stream, walking south, until the stream becomes a river and you can no longer touch the bottom. Then you float with your eyes closed, until the river washes you up on an asphalt shore, where two boys play baseball at dusk.

You feel your time is drawing short. You won't be able to stay here long.

>x
What do you want to examine?

>boy
Time is short: you must leave this place.

>n
A Group of Boys
You make your way qucikly north, but a group of smiling boys jumps in front of you.

"Kimchi! My name is Bae! Hello! I love you! My name is Chin-ho!"

>n
There is no more time to spare: you must keep moving.

A Pavilion
You manage to break away from the group of boys. Running now, panting, you've hardly any time left. Glancing to your right, you see a man helping a yong boy take off his shoes before entering a pavilion.

>z
There is no time to stop now.

>s
A Group of Boys
You make your way qucikly south, but a group of smiling boys jumps in front of you.

"Kimchi! My name is Bae! Hello! I love you! My name is Chin-ho!"

* * *

>s
There is no more time to spare: you must keep moving.

Sandlot
You follow the stream, walking south, until the stream becomes a river and you can no longer touch the bottom. Then you float with your eyes closed, until the river washes you up on an asphalt shore, where two boys play baseball at dusk.

You feel your time is drawing short. You won't be able to stay here long.

>n
A Group of Boys
You make your way qucikly north, but a group of smiling boys jumps in front of you.

"Kimchi! My name is Bae! Hello! I love you! My name is Chin-ho!"

>s
There is no more time to spare: you must keep moving.

Sandlot
You follow the stream, walking south, until the stream becomes a river and you can no longer touch the bottom. Then you float with your eyes closed, until the river washes you up on an asphalt shore, where two boys play baseball at dusk.

You feel your time is drawing short. You won't be able to stay here long.

>s
A Stream
You run far this time, and come upon a stream where a father plays with his two daughters.

>n
Sandlot
You follow the stream, walking north, until the stream becomes a river and you can no longer touch the bottom. Then you float with your eyes closed, until the river washes you up on an asphalt shore, where two boys play baseball at dusk.

You feel your time is drawing short. You won't be able to stay here long.

* * *

>s
There is no more time to spare: you must keep moving.

Sandlot
You follow the stream, walking south, until the stream becomes a river and you can no longer touch the bottom. Then you float with your eyes closed, until the river washes you up on an asphalt shore, where two boys play baseball at dusk.

You feel your time is drawing short. You won't be able to stay here long.

>x boy
Time is short: you must leave this place.

>s
A Stream
You run far this time, and come upon a stream where a father plays with his two daughters.

* * *

>n
There is no more time to spare: you must keep moving.

A Pavilion
You manage to break away from the group of boys. Running now, panting, you've hardly any time left. Glancing to your right, you see a man helping a yong boy take off his shoes before entering a pavilion.

>n
Leaving
You're flying now, faster than you've ever flown before... the air that streams by you feels like a thick liquid. Glancing over your shoulder, your last glimpse of Korea is a girl in red stripes, holding an umbrella.

And then she's gone.

    *** Being There. A notgame for Korea, created by Jordan Magnuson. ***

Would you like to RESTART, RESTORE a saved game, or QUIT?

>s
Please give one of the answers above.

Would you like to RESTART, RESTORE a saved game, or QUIT?

>restart
Blossom Street
A street stretches in front of you. You don't know this street, but it exists. Above you, and all around you, are cherry blossoms: they fill the street gutter; they overflow onto a yellow stripe of paint; they enter your nose, and come out your ears.

You see grass to the left. To the right is a yellow stripe, a streetlight, and a fence.

You could sit here if you wanted. You could run and dance on that yellow stripe. You could lie in the street and let the cherry blossoms burry you. If you wanted.

>n
Maisan Mountain
After traveling north for some time you find yourself atop Maisain Mountain, looking out over the farmland of North Jeolla. There's a golf course down there that you might just be able to touch, as well some man-made lakes and Geum River, winding itself towards the Yellow Sea.

You could dance in the sky here, if you wanted. You could probably fly.

* * *

>n
Napo Field
You fly north until you can fly no more. Then you land here, in a middle school soccer field.

The air is cool and crisp to the touch. Autumn has come, and the birds will be here soon, stopping in this field on their way south. Or maybe they've already been.

There are some parallel bars in the distance. You could swing from those bars, or climb that barren tree. Or yoo could just keep going north.

I beg your pardon?

>n
Temple Spring
You wander north for hours, searching for you don't know what. And then you find it: a fresh spring at the temple of the nirvana fish, spouting clean, cold water from a bamboo shoot.

The water flows onto a stone platform, then over the edge, and away.

You can see a cup here.

* * *

>n
A Stream
You run far this time, and come upon a stream where a father plays with his two daughters.

I beg your pardon?

>n
Sandlot
You follow the stream, walking north, until the stream becomes a river and you can no longer touch the bottom. Then you float with your eyes closed, until the river washes you up on an asphalt shore, where two boys play baseball at dusk.

You feel your time is drawing short. You won't be able to stay here long.

* * *

>n
A Group of Boys
You make your way qucikly north, but a group of smiling boys jumps in front of you.

"Kimchi! My name is Bae! Hello! I love you! My name is Chin-ho!"

>n
A Pavilion
You manage to break away from the group of boys. Running now, panting, you've hardly any time left. Glancing to your right, you see a man helping a yong boy take off his shoes before entering a pavilion.

>x girl
You can't see any such thing.

>x boy
You can't see any such thing.

>z
There is no time to stop now.

>x boy
You can't see any such thing.

* * *

>n
A Stream
You run far this time, and come upon a stream where a father plays with his two daughters.

>talk to
What do you want to talk to?

>talk
That's not a verb I recognize.

* * *

>talk to
What do you want to talk to?

>the girls
You say hello to the Korean girls.

>say hi to man
You say hello to the Korean man.

>say hi to girls
You say hello to the Korean girls.

>goodbye
You say goodbye to the Korean girls.

>say hello
(addressing the Korean girls)
You say hello to the Korean girls.

>talk
What do you want to talk to?

>man
You say hello to the Korean man.

* * *

>n
A Stream
You run far this time, and come upon a stream where a father plays with his two daughters.

>ask man
(for the Korean Man)
(first trying to take the Korean Man)
I don't suppose the Korean Man would care for that.

>x man
A middle aged Korean man, having fun with his daughters.

* * *

>n
A Stream
You run far this time, and come upon a stream where a father plays with his two daughters.

>talk to
(the Korean Man)
You say hello to the Korean Man.

>ask man
(for the Korean Man)

>hello
You are already talking to the Korean Man.

>ask man about blossom
Which do you mean, the cherry blossoms, or the cherry blossom trees?

>cherry blossoms
There is no reply.

>say hello
You are already talking to the Korean Man.

>stop
That's not a verb I recognize.

>s
Kimchi Pots
Walking south you come upon some gaint Kimchi pots.

If there was kimchi in one of those pots you could eat it... you could put it in your mouth and let the spices soak your tongue.

You could climb into one of the pots and sing until your voice was hoarse.

You could stand on top of one of them and jump up and down until someone made you stop.

You could do a million things. Or nothing at all.

>n
A Stream
You run far this time, and come upon a stream where a father plays with his two daughters.

You can see a Korean Man here.

>say hello
(addressing the Korean Man)
You say hello to the Korean Man.

* * *

>n
A Stream
You run far this time, and come upon a stream where a father plays with his two daughters.

>x girls
You see nothing special about the Korean girls.

>talk to
What do you want to talk to?

>the day
You can't see any such thing.

>say hello
(addressing the Korean girls)
You say hello to the Korean girls.

>x nos
You can't see any such thing.

>x nose
Which do you mean, your nose, the Korean Man's nose, or the Korean girls's nose?

>my nose
You see nothing special about your nose.

>x arm
You can't see any such thing.

>x leg
Which do you mean, your leg, the Korean Man's leg, or the Korean girls's leg?

>korean
Which do you mean, the Korean Man's leg, or the Korean girls's leg?

>girl
You can't see any such thing.

* * *

>n
A Stream
You run far this time, and come upon a stream where a father plays with his two daughters.

>x swimsuit
You see nothing special about the black swimsuit.

* * *

>n
A Pavilion
You manage to break away from the group of boys. Running now, panting, you've hardly any time left. Glancing to your right, you see a man helping a yong boy take off his shoes before entering a pavilion.

>x boy
You can't see any such thing.

>s
A Group of Boys
You make your way qucikly south, but a group of smiling boys jumps in front of you.

"Kimchi! My name is Bae! Hello! I love you! My name is Chin-ho!"

>x boy
There is no more time to spare: you must keep moving.

>x boy
There is no more time to spare: you must keep moving.

>n
A Pavilion
You manage to break away from the group of boys. Running now, panting, you've hardly any time left. Glancing to your right, you see a man helping a yong boy take off his shoes before entering a pavilion.

>z
There is no time to stop now.

* * *

>s
A Group of Boys
You make your way qucikly south, but a group of smiling boys jumps in front of you.

"Kimchi! My name is Bae! Hello! I love you! My name is Chin-ho!"

>x water
You can't see any such thing.

>x boy
There is no more time to spare: you must keep moving.

>leave
There is no time to stop now.

>leave
Leaving
You're flying now, faster than you've ever flown before... the air that streams by you feels like a thick liquid. Glancing over your shoulder, your last glimpse of Korea is a girl in red stripes, holding an umbrella.

And then she's gone.

    *** Being There. A notgame for Korea, created by Jordan Magnuson. ***

Would you like to RESTART, RESTORE a saved game, or QUIT?

>restart
Blossom Street
A street stretches in front of you. You don't know this street, but it exists. Above you, and all around you, are cherry blossoms: they fill the street gutter; they overflow onto a yellow stripe of paint; they enter your nose, and come out your ears.

You see grass to the left. To the right is a yellow stripe, a streetlight, and a fence.

You could sit here if you wanted. You could run and dance on that yellow stripe. You could lie in the street and let the cherry blossoms burry you. If you wanted.

* * *

>n
Sandlot
You follow the stream, walking north, until the stream becomes a river and you can no longer touch the bottom. Then you float with your eyes closed, until the river washes you up on an asphalt shore, where two boys play baseball at dusk.

You feel your time is drawing short. You won't be able to stay here long.

I beg your pardon?

>n
A Group of Boys
You make your way qucikly north, but a group of smiling boys jumps in front of you.

"Kimchi! My name is Bae! Hello! I love you! My name is Chin-ho!"

>x water
You can't see any such thing.

>x fridge
You can't see any such thing.

>golns
That's not a verb I recognize.

>eat apple
You can't see any such thing.

* * *

>n
Kimchi Pots
Walking north you come upon some gaint Kimchi pots.

If there was kimchi in one of those pots you could eat it... you could put it in your mouth and let the spices soak your tongue.

You could climb into one of the pots and sing until your voice was hoarse.

You could stand on top of one of them and jump up and down until someone made you stop.

You could do a million things. Or nothing at all.

>x pots
You can't see any such thing.

>x kimchi pot
Large pots made for holding Korea's favorite food. Big enough to climb into.

>open kimchi pot
You open the kimchi pot, revealing some kimchi.

>open kimchi pot
That's already open.

>x kimchi
(the kimchi pot)
Large pots made for holding Korea's favorite food. Big enough to climb into.

>x kimchi food
A giant pile of spiced cabbage

* * *

>n
Kimchi Pots
Walking north you come upon some gaint Kimchi pots.

If there was kimchi in one of those pots you could eat it... you could put it in your mouth and let the spices soak your tongue.

You could climb into one of the pots and sing until your voice was hoarse.

You could stand on top of one of them and jump up and down until someone made you stop.

You could do a million things. Or nothing at all.

>x kimchi
You can't see any such thing.

>x pots
Large pots made for holding Korea's favorite food. Big enough to climb into.

>x pot
Large pots made for holding Korea's favorite food. Big enough to climb into.

>open pot
You open the pot, revealing a small mountain of kimchi.

>x kimchi
(the kimchi)
Spiced, fermented cabbage. Koreans eat this stuff with every meal.

>x pot
Large pots made for holding Korea's favorite food. Big enough to climb into.

>x in pot
I only understood you as far as wanting to examine inside.

>look in pot
In the pot is a small mountain of kimchi.

>x food
Spiced, fermented cabbage. Koreans eat this stuff with every meal.

>x kimchi food
Spiced, fermented cabbage. Koreans eat this stuff with every meal.

>x kimchi
(the kimchi)
Spiced, fermented cabbage. Koreans eat this stuff with every meal.

>eat kimchi
(the pot)
Pretty much what you would expect.

>s
Temple Spring
You wander south for hours, searching for you don't know what. And then you find it: a fresh spring at the temple of the nirvana fish, spouting clean, cold water from a bamboo shoot.

The water flows onto a stone platform, then over the edge, and away.

You can see a cup here.

>n
Kimchi Pots
Walking north you come upon some gaint Kimchi pots.

If there was kimchi in one of those pots you could eat it... you could put it in your mouth and let the spices soak your tongue.

You could climb into one of the pots and sing until your voice was hoarse.

You could stand on top of one of them and jump up and down until someone made you stop.

You could do a million things. Or nothing at all.

>x kimchi
(the kimchi)
Spiced, fermented cabbage. Koreans eat this stuff with every meal.

>close pot
You close the pot.

>s
Temple Spring
You wander south for hours, searching for you don't know what. And then you find it: a fresh spring at the temple of the nirvana fish, spouting clean, cold water from a bamboo shoot.

The water flows onto a stone platform, then over the edge, and away.

You can see a cup here.

* * *

>n
Kimchi Pots
Walking north you come upon some gaint Kimchi pots.

If there was kimchi in one of those pots you could eat it... you could put it in your mouth and let the spices soak your tongue.

You could climb into one of the pots and sing until your voice was hoarse.

You could stand on top of one of them and jump up and down until someone made you stop.

You could do a million things. Or nothing at all.

>x kimchi
Large pots made for holding Korea's favorite food. Big enough to climb into.

>look in pot
(first opening the pot)
In the pot is a small mountain of kimchi.

>close pot
You close the pot.

>sit in pot
You can't get into the closed pot.

>open pot
You open the pot, revealing a small mountain of kimchi.

>sit in pot
You are now seated in the pot. You feel a pebble beneath your buttock.

>dance in pot
You can't take that position in the pot.

>eat kimchi
(the pot)
Pretty much what you would expect.

* * *

>x kimchi
You can't see any such thing.

>x pot
Large pots made for holding Korea's favorite food. Big enough to climb into.

* * *

>open pot
You open the pot, revealing a small mountain of kimchi.

>eat kimchi
Pretty much what you would expect.

>enter pot
You get into the pot.

In the pot you can see a small mountain of kimchi.

>exit pot
I only understood you as far as wanting to exit.

>get out of pot
I only understood you as far as wanting to get outside.

>exit
You get out of the pot.

Kimchi Pots
Walking north you come upon some gaint Kimchi pots.

If there was kimchi in one of those pots you could eat it... you could put it in your mouth and let the spices soak your tongue.

You could climb into one of the pots and sing until your voice was hoarse.

You could stand on top of one of them and jump up and down until someone made you stop.

You could do a million things. Or nothing at all.

>exit pot
I only understood you as far as wanting to exit.

>enter pot
You get into the pot.

In the pot you can see a small mountain of kimchi.

>exit
You get out of the pot.

Kimchi Pots
Walking north you come upon some gaint Kimchi pots.

If there was kimchi in one of those pots you could eat it... you could put it in your mouth and let the spices soak your tongue.

You could climb into one of the pots and sing until your voice was hoarse.

You could stand on top of one of them and jump up and down until someone made you stop.

You could do a million things. Or nothing at all.

>climb into pot
You can't see any such thing.

>get into pot
You get into the pot.

In the pot you can see a small mountain of kimchi.

>exit
You get out of the pot.

Kimchi Pots
Walking north you come upon some gaint Kimchi pots.

If there was kimchi in one of those pots you could eat it... you could put it in your mouth and let the spices soak your tongue.

You could climb into one of the pots and sing until your voice was hoarse.

You could stand on top of one of them and jump up and down until someone made you stop.

You could do a million things. Or nothing at all.

>get into
(the pot)
You get into the pot.

In the pot you can see a small mountain of kimchi.

>get out of
I only understood you as far as wanting to get outside.

>get out
You get out of the pot.

Kimchi Pots
Walking north you come upon some gaint Kimchi pots.

If there was kimchi in one of those pots you could eat it... you could put it in your mouth and let the spices soak your tongue.

You could climb into one of the pots and sing until your voice was hoarse.

You could stand on top of one of them and jump up and down until someone made you stop.

You could do a million things. Or nothing at all.

>climb into
You can't see any such thing.

* * *

>n
Kimchi Pots
Walking north you come upon some gaint Kimchi pots.

If there was kimchi in one of those pots you could eat it... you could put it in your mouth and let the spices soak your tongue.

You could climb into one of the pots and sing until your voice was hoarse.

You could stand on top of one of them and jump up and down until someone made you stop.

You could do a million things. Or nothing at all.

>stand on pot
You are now standing on kimchi pot. You feel tall.

>sit on pot
You can't get into the closed the kimchi pot.

>stand in pot
You are now standing on the supporter-pot. You can feel the ground through your legs.

>open kimchi pot
You open the the kimchi pot, revealing a small mountain of kimchi.

>stand in pot
You are now standing on the supporter-pot. The ground under your feet is firm.

* * *

>stand on pot
You are now standing on kimchi pot. You feel tall.

>stand in pot
the pot is closed baby.

* * *

>n
Kimchi Pots
Walking north you come upon some gaint Kimchi pots.

If there was kimchi in one of those pots you could eat it... you could put it in your mouth and let the spices soak your tongue.

You could climb into one of the pots and sing until your voice was hoarse.

You could stand on top of one of them and jump up and down until someone made you stop.

You could do a million things. Or nothing at all.

>stand in pot
You can't get into the closed kimchi pot.

>stand on pot
You are now standing on the kimchi pot. You feel tall.

* * *

>n
Kimchi Pots
Walking north you come upon some gaint Kimchi pots.

If there was kimchi in one of those pots you could eat it... you could put it in your mouth and let the spices soak your tongue.

You could climb into one of the pots and sing until your voice was hoarse.

You could stand on top of one of them and jump up and down until someone made you stop.

You could do a million things. Or nothing at all.

>open pot
You open a kimchi pot, revealing more kimchi than you know what to do with.

>stand on pot
You are now standing on the kimchi pot. You feel tall.

>show me pot
(first trying to take the kimchi pot)
They're hardly portable.

>showme pot
(the kimchi pot)
kimchi pot - open container
    kimchi - kimchi food
location: in Kimchi Pots
unlit; inedible; fixed in place; scenery; plural-named; improper-named; neuter; ordinarily enumerated; unswingable; weak_smelling; soft_sounding
description: Large pots made for holding Korea's favorite food. Big enough to climb into... or stand on.
printed name: kimchi pot
indefinite article: a
printed plural name: containers
feeling: normal
flavor: normal
odor: normal
sound: silence
enterable; opaque; open; openable; unlocked
carrying capacity: 100
known-key: no-key
posture: seated

>stand in pot
(getting off the kimchi pot)
You are now standing in the kimchi pot. You feel a breeze behind you.

>clear
What do you want to clear?

>s
You must name something more substantial.

>n
(first leaving the kimchi pot)

A Stream
You run far this time, and come upon a stream where a father plays with his daughters.

>s
Kimchi Pots
Walking south you come upon some gaint Kimchi pots.

If there was kimchi in one of those pots you could eat it... you could put it in your mouth and let the spices soak your tongue.

You could climb into one of the pots and sing until your voice was hoarse.

You could stand on top of one of them and jump up and down until someone made you stop.

You could do a million things. Or nothing at all.

>close pot
You close the kimchi pot.

>s
Temple Spring
You wander south for hours, searching for you don't know what. And then you find it: a fresh spring at the temple of the nirvana fish, spouting clean, cold water from a bamboo shoot.

The water flows onto a stone platform, then over the edge, and away.

You can see a cup here.

* * *

>n
Kimchi Pots
Walking north you come upon some gaint Kimchi pots.

If there was kimchi in one of those pots you could eat it... you could put it in your mouth and let the spices soak your tongue.

You could climb into one of the pots and sing until your voice was hoarse.

You could stand on top of one of them and jump up and down until someone made you stop.

You could do a million things. Or nothing at all.

>x pot
Large pots made for holding Korea's favorite food. Big enough to climb into... or stand on.

>get in pot
You can't get into the closed kimchi pot.

>showme pot
(the kimchi pot)
kimchi pot - closed container
    kimchi - kimchi food
location: in Kimchi Pots
unlit; inedible; fixed in place; scenery; plural-named; improper-named; neuter; ordinarily enumerated; unswingable; weak_smelling; soft_sounding
description: Large pots made for holding Korea's favorite food. Big enough to climb into... or stand on.
printed name: kimchi pot
indefinite article: a
printed plural name: containers
feeling: normal
flavor: normal
odor: normal
sound: silence
enterable; opaque; closed; openable; unlocked
carrying capacity: 100
known-key: no-key
posture: seated

>s
Temple Spring
You wander south for hours, searching for you don't know what. And then you find it: a fresh spring at the temple of the nirvana fish, spouting clean, cold water from a bamboo shoot.

The water flows onto a stone platform, then over the edge, and away.

You can see a cup here.

* * *

>n
Kimchi Pots
Walking north you come upon some gaint Kimchi pots.

If there was kimchi in one of those pots you could eat it... you could put it in your mouth and let the spices soak your tongue.

You could climb into one of the pots and sing until your voice was hoarse.

You could stand on top of one of them and jump up and down until someone made you stop.

You could do a million things. Or nothing at all.

>close pot
They're already closed.

>open pot
You open the kimchi pot, revealing a small mountain of kimchi.

>stand on pot
You are now standing on the kimchi pot. You can feel the ground through your legs.

>stand in pot
(getting off the kimchi pot)
You are now standing in the kimchi pot. Life is good.

>sit in pot
You are now seated in the kimchi pot. You feel a pebble beneath your buttock.

>sit on pot
(getting out of the kimchi pot)
You can't take that position on the kimchi pot.

>stand on pot
You are now standing on the kimchi pot. The ground under your feet is firm.

>sing on pot
(getting off the kimchi pot)
You are now singing in the kimchi pot.

* * *

>open pot
You open a kimchi pot, revealing more kimchi than you know what to do with.

>dance in pot
You can't take that position in the open kimchi pot.

>sit in pot
You are now seated in the open kimchi pot. You feel a pebble beneath your buttock.

* * *

>open pot
You open a kimchi pot, revealing more kimchi than you know what to do with.

>sit in pot
You are now seated in an open kimchi pot. You feel a pebble beneath your buttock.

* * *

>open pot
You open a kimchi pot, revealing more kimchi than you know what to do with.

>take kimchi
You have no pockets, and the pots are too large to carry.

>showme kimchi
Which do you mean, Kimchi Pots, or the kimchi?

>show me pot
(first trying to take the open kimchi pot)
That's hardly portable.

>showme pot
open kimchi pot - open container
    kimchi - kimchi food
location: in Kimchi Pots
unlit; inedible; fixed in place; scenery; singular-named; improper-named; neuter; ordinarily enumerated; unswingable; one-of-many; weak_smelling; soft_sounding
description: Large pots made for holding Korea's favorite food. Big enough to climb into... or stand on.
printed name: open kimchi pot
printed plural name: containers
feeling: normal
flavor: normal
odor: normal
sound: silence
enterable; opaque; open; openable; unlocked
carrying capacity: 100
known-key: no-key
posture: seated

>s
Temple Spring
You wander south for hours, searching for you don't know what. And then you find it: a fresh spring at the temple of the nirvana fish, spouting clean, cold water from a bamboo shoot.

The water flows onto a stone platform, then over the edge, and away.

You can see a cup here.

* * *

>n
Kimchi Pots
Walking north you come upon some gaint Kimchi pots.

If there was kimchi in one of those pots you could eat it... you could put it in your mouth and let the spices soak your tongue.

You could climb into one of the pots and sing until your voice was hoarse.

You could stand on top of one of them and jump up and down until someone made you stop.

You could do a million things. Or nothing at all.

>close pot
You close the open kimchi pot.

>open pot
You open a kimchi pot, revealing more kimchi than you know what to do with.

>open pot
That's already open.

>dance on pot
You are now dancing on a closed kimchi pot. You spin and you spin, until you can't see straight.

>dance in pot
(getting off the closed kimchi pot)
You can't take that position in an open kimchi pot.

>sing in pot
You are now singing in an open kimchi pot.

>eat kimchi
Pretty much what you would expect.

>climb into pot
But you're already in the open kimchi pot.

>stand on pot
(getting out of the open kimchi pot)
You are now standing on a closed kimchi pot. You feel tall.

>jump
You jump on the spot. You feel a breeze behind you.

>jump on pot
I only understood you as far as wanting to jump.

>jump
You jump on the spot.

>jump
You jump on the spot. Life is good.

>jump
You jump on the spot. The breeze ruffles your hair.

>jump
You jump on the spot. A bird flies by, and looks at you.

>jump
You jump on the spot. It feels like you've been here before.

>spin
You are now dancing on a closed kimchi pot. You hear rain in the distance.

>spin on pot
I only understood you as far as wanting to spin.

>spin
You are already dancing.

>jump up and down
I only understood you as far as wanting to jump.

>jump
You jump on the spot.

>s
(first leaving the closed kimchi pot)

Temple Spring
You wander south for hours, searching for you don't know what. And then you find it: a fresh spring at the temple of the nirvana fish, spouting clean, cold water from a bamboo shoot.

The water flows onto a stone platform, then over the edge, and away.

You can see a cup here.

>s
Napo Field
You fly south until you can fly no more. Then you land here, in a middle school soccer field.

The air is cool and crisp to the touch. Autumn has come, and the birds will be here soon, stopping in this field on their way south. Or maybe they've already been.

There are some parallel bars in the distance. You could swing from those bars, or climb that barren tree. Or yoo could just keep going south.

* * *

>s
Maisan Mountain
After traveling south for some time you find yourself atop Maisain Mountain, looking out over the farmland of North Jeolla. There's a golf course down there that you might just be able to touch, as well some man-made lakes and Geum River, winding itself towards the Yellow Sea.

You could dance in the sky here, if you wanted. You could probably fly.

>dance in sky
You are now dancing in the sky. Is this what flying feels like?

>jump
You jump on the spot. Above you is the sky.

>jump in sky
I only understood you as far as wanting to jump.

>n
(first leaving the sky)

Napo Field
You fly north until you can fly no more. Then you land here, in a middle school soccer field.

The air is cool and crisp to the touch. Autumn has come, and the birds will be here soon, stopping in this field on their way south. Or maybe they've already been.

There are some parallel bars in the distance. You could swing from those bars, or climb that barren tree. Or yoo could just keep going north.

>n
Temple Spring
You wander north for hours, searching for you don't know what. And then you find it: a fresh spring at the temple of the nirvana fish, spouting clean, cold water from a bamboo shoot.

The water flows onto a stone platform, then over the edge, and away.

You can see a cup here.

* * *

>open pot
You open a kimchi pot, revealing more kimchi than you know what to do with.

>eat kimchi
You take a bite of the kimchi. Spicy and delicious.

>taste kimchi
You take another bite.

>eat kimchi
You eat more. And more. You're starting to get addicted.

>eat kimchi
You eat more. And more. You're starting to get addicted.

>eat kimchi
Okay, you're addicted.

>n
A Stream
You run far this time, and come upon a stream where a father plays with his daughters.

>s
Kimchi Pots
Walking south you come upon some gaint Kimchi pots.

If there was kimchi in one of those pots you could eat it... you could put it in your mouth and let the spices soak your tongue.

You could climb into one of the pots and sing until your voice was hoarse.

You could stand on top of one of them and jump up and down until someone made you stop.

You could do a million things. Or nothing at all.

* * *

>s
Temple Spring
You wander south for hours, searching for you don't know what. And then you find it: a fresh spring at the temple of the nirvana fish, spouting clean, cold water from a bamboo shoot.

The water flows onto a stone platform, then over the edge, and away.

You can see a cup here.

>x bamboo
Tubes made from bamboo.

>n
Kimchi Pots
Walking north you come upon some gaint Kimchi pots.

If there was kimchi in one of those pots you could eat it... you could put it in your mouth and let the spices soak your tongue.

You could climb into one of the pots and sing until your voice was hoarse.

You could stand on top of one of them and jump up and down until someone made you stop.

You could do a million things. Or nothing at all.

* * *

>n
A Stream
You run far this time, and come upon a stream where a father plays with his daughters.

>x stream
You can't see any such thing.

* * *

>n
Kimchi Pots
Walking north you come upon some gaint Kimchi pots.

If there was kimchi in one of those pots you could eat it... you could put it in your mouth and let the spices soak your tongue.

You could climb into one of the pots and sing until your voice was hoarse.

You could stand on top of one of them and jump up and down until someone made you stop.

You could do a million things. Or nothing at all.

>sing on pot
You are now singing on the kimchi pot.

>dance on pot
You are now dancing on the kimchi pot. You spin and you spin, until you can't see straight.

>eat kimchi
You can't see any such thing.

>open pot
You open the kimchi pot, revealing a small mountain of kimchi.

>showme kimchi
Which do you mean, Kimchi Pots, or the kimchi?

>pots
I only understood you as far as wanting to showme the kimchi pot.

>showme pot
kimchi pot - open container
    kimchi - kimchi food
location: in Kimchi Pots
unlit; inedible; fixed in place; scenery; plural-named; improper-named; neuter; ordinarily enumerated; unswingable; weak_smelling; soft_sounding
description: Large pots made for holding Korea's favorite food. Big enough to climb into... or stand on.
printed name: kimchi pot
indefinite article: a
printed plural name: containers
feeling: normal
flavor: normal
odor: normal
sound: silence
enterable; opaque; open; openable; unlocked
carrying capacity: 100
known-key: no-key
posture: seated

>sing in pot
(getting off the kimchi pot)
You are now singing in the kimchi pot.

* * *

>x pot
Large pots made for holding Korea's favorite food. Big enough to climb into... or stand on.

>stand on pot
You are now standing on the closed kimchi pot. You feel tall.

>get in pot
You can't get into the closed kimchi pot.

>open pot
You open the open kimchi pot, revealing a small mountain of kimchi.

>sing in pot
(getting off the closed kimchi pot)
You are now singing in the open kimchi pot.

>stand on pot
(getting out of the open kimchi pot)
You are now standing on the closed kimchi pot. You can feel the ground through your legs.

* * *

>n
Kimchi Pots
Walking north you come upon some gaint Kimchi pots.

If there was kimchi in one of those pots you could eat it... you could put it in your mouth and let the spices soak your tongue.

You could climb into one of the pots and sing until your voice was hoarse.

You could stand on top of one of them and jump up and down until someone made you stop.

You could do a million things. Or nothing at all.

>eat kimchi
You can't see any such thing.

>open jar
You open a kimchi pot, revealing more kimchi than you know what to do with.

>eat kimchi
Pretty much what you would expect.

>eat kimcih
You can't see any such thing.

>eat kimchi
Pretty much what you would expect.

>eat kimchi
Pretty much what you would expect.

>s
Temple Spring
You wander south for hours, searching for you don't know what. And then you find it: a fresh spring at the temple of the nirvana fish, spouting clean, cold water from a bamboo shoot.

The water flows onto a stone platform, then over the edge, and away.

You can see a cup here.

* * *

>s
Blossom Street
A street stretches in front of you. You don't know this street, but it exists. Above you, and all around you, are cherry blossoms: they fill the street gutter; they overflow onto a yellow stripe of paint; they enter your nose, and come out your ears.

You see grass to the left. To the right is a yellow stripe, a streetlight, and a fence.

You could sit here if you wanted. You could run and dance on that yellow stripe. You could lie in the street and let the cherry blossoms burry you. If you wanted.

>eat flower
You put a flower in your mouth. It tastes like the past.

>eat flower
You put a flower in your mouth. It tastes like the past.

* * *

>n
Temple Spring
You wander north for hours, searching for you don't know what. And then you find it: a fresh spring at the temple of the nirvana fish, spouting clean, cold water from a bamboo shoot.

The water flows onto a stone platform, then over the edge, and away.

You can see a cup here.

>s
Blossom Street

* * *

>n
Maisain Mountain

>n
You can't go that way.

>n
You can't go that way.

* * *

>n
Temple Spring
You wander north for hours, searching for you don't know what. And then you find it: a fresh spring at the temple of the nirvana fish, spouting clean, cold water from a bamboo shoot.

The water flows onto a stone platform, then over the edge, and away.

You can see a cup here.

>drink water
Ignoring the cups, you place your mouth to the fountain, and drink for a long moment. The water freezes your lips and chin, but it tastes like heaven.

>drink
(the cup)
Ignoring the cups, you place your mouth to the fountain, and drink long and deep.

>drink
(the cup)
Ignoring the cups, you place your mouth to the fountain, and drink long and deep.

* * *

>drink water
Ignoring the cups, you place your mouth to the fountain, and drink for a long moment. The water freezes your lips and chin, but it tastes like heaven.

>x water
The water looks clear and delicious.

>x The water
The water looks clear and delicious.

>x cup
Communal plastic cups are a norm in Korea.

>look at cup
Communal plastic cups are a norm in Korea.

>drink
(the water)
Ignoring the cups, you place your mouth to the fountain, and drink for a long moment. The water freezes your lips and chin, but it tastes like heaven.

>the water
That's not a verb I recognize.

>drink the cup
There's nothing suitable to drink here.

>drink
(the water)
Ignoring the cups, you place your mouth to the fountain, and drink for a long moment. The water freezes your lips and chin, but it tastes like heaven.

>x cups
You can't see any such thing.

>x cup
Communal plastic cups are a norm in Korea.

>use cup
That's not a verb I recognize.

>touch cup
Pretty much what you would expect.

>taste cup
Pretty much what you would expect.

>listen to cup
Silence.

>listen to water
Silence.

>drink water with cup
I only understood you as far as wanting to drink the water.

>drink water
Ignoring the cups, you place your mouth to the fountain, and drink for a long moment. The water freezes your lips and chin, but it tastes like heaven.

* * *

>n
Temple Spring
You wander north for hours, searching for you don't know what. And then you find it: a fresh spring at the temple of the nirvana fish, spouting clean, cold water from a bamboo shoot.

The water flows onto a stone platform, then over the edge, and away.

You can see a cup here.

>take cup
Taken.

>drink
(the cup)
There's nothing suitable to drink here.

>drink
(the cup)
There's nothing suitable to drink here.

>x water
You see nothing special about the water.

>x the water
You see nothing special about the water.

* * *

>n
Temple Spring
You wander north for hours, searching for you don't know what. And then you find it: a fresh spring at the temple of the nirvana fish, spouting clean, cold water from a bamboo shoot.

The water flows onto a stone platform, then over the edge, and away.

You can see a cup here.

>x moss
The rocks here are overgrown with moss and vines, like all good rocks should be.

>climb rocks
The rocks are damp and slippery, but you climb them as best you can.

>sing
You are now singing.

>dance
You are now dancing. You feel a breeze behind you.

>platform
That's not a verb I recognize.

>dance on platform
You are now dancing on the stone platform. You spin and you spin, until you can't see straight.

>swim
(in the water)
Alas: you're not quite small enough to swim up the bamboon shoot. And if you were, you probably wouldn't be strong enough to swim up that fast current.

>swim in water
Alas: you're not quite small enough to swim up the bamboon shoot. And if you were, you probably wouldn't be strong enough to swim up that fast current.

* * *

>n
Temple Spring
You wander north for hours, searching for you don't know what. And then you find it: a fresh spring at the temple of the nirvana fish, spouting clean, cold water from a bamboo shoot.

The water flows onto a stone platform, then over the edge, and away.

You can see a cup here.

>restart
Sandlot
You follow the stream, walking , until the stream becomes a river and you can no longer touch the bottom. Then you float with your eyes closed, until the river washes you up on an asphalt shore, where two boys play baseball at dusk.

You feel your time is drawing short. You won't be able to stay here long.

Sandlot
You follow the stream, walking , until the stream becomes a river and you can no longer touch the bottom. Then you float with your eyes closed, until the river washes you up on an asphalt shore, where two boys play baseball at dusk.

You feel your time is drawing short. You won't be able to stay here long.

* * *

>n
A Group of Boys
You make your way quickly north, but a group of smiling boys jumps in front of you.

"Kimchi! My name is Bae! Hello! I love you! My name is Chin-ho!"

>s
A Group of Boys
You follow the stream, walking south, until the stream becomes a river and you can no longer touch the bottom. Then you float with your eyes closed, until the river washes you up on an asphalt shore, where two boys play baseball at dusk.

You feel your time is drawing short. You won't be able to stay here long.

>s
Sandlot
You follow the stream, walking south, until the stream becomes a river and you can no longer touch the bottom. Then you float with your eyes closed, until the river washes you up on an asphalt shore, where two boys play baseball at dusk.

You feel your time is drawing short. You won't be able to stay here long.

2

>n
A Group of Boys
You follow the stream, walking north, until the stream becomes a river and you can no longer touch the bottom. Then you float with your eyes closed, until the river washes you up on an asphalt shore, where two boys play baseball at dusk.

You feel your time is drawing short. You won't be able to stay here long.

>n
Napo Field

I beg your pardon?

>s
Maisan Mountain

>s
Blossom Street

>n
Maisan Mountain

>n
Napo Field

>s
Maisan Mountain

* * *

>n
A Group of Boys
You follow the stream, walking north, until the stream becomes a river and you can no longer touch the bottom. Then you float with your eyes closed, until the river washes you up on an asphalt shore, where two boys play baseball at dusk.

You feel your time is drawing short. You won't be able to stay here long.

>s
Sandlot
You follow the stream, walking south, until the stream becomes a river and you can no longer touch the bottom. Then you float with your eyes closed, until the river washes you up on an asphalt shore, where two boys play baseball at dusk.

You feel your time is drawing short. You won't be able to stay here long.

1

>s
A Stream
You run far this time, and come upon a stream where a father plays with his two daughters.

>n
Sandlot
You follow the stream, walking north, until the stream becomes a river and you can no longer touch the bottom. Then you float with your eyes closed, until the river washes you up on an asphalt shore, where two boys play baseball at dusk.

You feel your time is drawing short. You won't be able to stay here long.

0

>n
There is no time. You must leave this place.

A Group of Boys
You follow the stream, walking north, until the stream becomes a river and you can no longer touch the bottom. Then you float with your eyes closed, until the river washes you up on an asphalt shore, where two boys play baseball at dusk.

You feel your time is drawing short. You won't be able to stay here long.

A Pavilion
You run far this time. Past all the empty places, until you find two boys playing baseball at dusk in an empty lot.

>s
A Group of Boys
You follow the stream, walking south, until the stream becomes a river and you can no longer touch the bottom. Then you float with your eyes closed, until the river washes you up on an asphalt shore, where two boys play baseball at dusk.

You feel your time is drawing short. You won't be able to stay here long.

>s
Sandlot
You follow the stream, walking south, until the stream becomes a river and you can no longer touch the bottom. Then you float with your eyes closed, until the river washes you up on an asphalt shore, where two boys play baseball at dusk.

You feel your time is drawing short. You won't be able to stay here long.

-1

>s
There is no time. You must leave this place.

A Group of Boys
You follow the stream, walking south, until the stream becomes a river and you can no longer touch the bottom. Then you float with your eyes closed, until the river washes you up on an asphalt shore, where two boys play baseball at dusk.

You feel your time is drawing short. You won't be able to stay here long.

Sandlot
You follow the stream, walking south, until the stream becomes a river and you can no longer touch the bottom. Then you float with your eyes closed, until the river washes you up on an asphalt shore, where two boys play baseball at dusk.

You feel your time is drawing short. You won't be able to stay here long.

-2

>s
There is no time. You must leave this place.

A Group of Boys
You follow the stream, walking south, until the stream becomes a river and you can no longer touch the bottom. Then you float with your eyes closed, until the river washes you up on an asphalt shore, where two boys play baseball at dusk.

You feel your time is drawing short. You won't be able to stay here long.

Sandlot
You follow the stream, walking south, until the stream becomes a river and you can no longer touch the bottom. Then you float with your eyes closed, until the river washes you up on an asphalt shore, where two boys play baseball at dusk.

You feel your time is drawing short. You won't be able to stay here long.

-3

* * *

>n
A Group of Boys
You make your way quickly north, but a group of smiling boys jumps in front of you.

"Kimchi! My name is Bae! Hello! I love you! My name is Chin-ho!"

I beg your pardon?

>g
Temple Spring
Lorem ipsum dolor sit amet, consectetur adipiscing elit. Nam aliquam ligula ac risus gravida auctor. Vestibulum ante ipsum primis in faucibus orci luctus et ultrices posuere cubilia Curae; Etiam malesuada diam et libero sagittis eget condimentum nulla interdum. Cras tincidunt molestie lorem, eu elementum elit suscipit quis. Donec sagittis, massa eget vestibulum congue, augue arcu iaculis ligula, vel pellentesque lectus magna non mauris. Nullam fermentum adipiscing posuere. Donec et neque mauris, ut mollis odio. Quisque pretium cursus elementum. Suspendisse eget turpis elementum leo semper laoreet ut a dui. Praesent facilisis, augue malesuada accumsan rhoncus, metus mi tincidunt est, eget dictum metus nibh sed velit. Cum sociis natoque penatibus et magnis dis parturient montes, nascetur ridiculus mus. Nulla aliquam, augue a vulputate hendrerit, lorem elit blandit lorem, a placerat est ante quis justo. Maecenas vitae mattis libero. Fusce et egestas augue.

>g
Kimchi Pots
Lorem ipsum dolor sit amet, consectetur adipiscing elit. Nam aliquam ligula ac risus gravida auctor. Vestibulum ante ipsum primis in faucibus orci luctus et ultrices posuere cubilia Curae; Etiam malesuada diam et libero sagittis eget condimentum nulla interdum. Cras tincidunt molestie lorem, eu elementum elit suscipit quis. Donec sagittis, massa eget vestibulum congue, augue arcu iaculis ligula, vel pellentesque lectus magna non mauris. Nullam fermentum adipiscing posuere. Donec et neque mauris, ut mollis odio. Quisque pretium cursus elementum. Suspendisse eget turpis elementum leo semper laoreet ut a dui. Praesent facilisis, augue malesuada accumsan rhoncus, metus mi tincidunt est, eget dictum metus nibh sed velit. Cum sociis natoque penatibus et magnis dis parturient montes, nascetur ridiculus mus. Nulla aliquam, augue a vulputate hendrerit, lorem elit blandit lorem, a placerat est ante quis justo. Maecenas vitae mattis libero. Fusce et egestas augue.

* * *

>n
A Group of Boys
You make your way quickly north, but a group of smiling boys jumps in front of you.

"Kimchi! My name is Bae! Hello! I love you! My name is Chin-ho!"

>swing
(on the parallel bars)
You swing on the parallel bars.

>swing on bars
You swing on the parallel bars.

>swing from bars
You swing on the parallel bars.

* * *

>n
A Group of Boys
You make your way quickly north, but a group of smiling boys jumps in front of you.

"Kimchi! My name is Bae! Hello! I love you! My name is Chin-ho!"

>stand on bars
You are now standing on the parallel bars. You feel tall.

>dacne on bars
That's not a verb I recognize.

>dance on bars
You are now dancing on the parallel bars. You feel a breeze behind you.

>climb bars
I don't think much is to be achieved by that.

>x tree
One tree shines gold, another has already lost all its leaves.

>climb trees
You climb to the top of the barren tree. The field looks distant, and small.

>x trees
One tree shines gold, another has already lost all its leaves.

>climb trees
You climb to the top of the barren tree. The field looks distant, and small.

>stand up
You are now standing on the parallel bars. You can feel the ground through your legs.

>sit down
You can't take that position on the parallel bars.

>get up
You get off the parallel bars.

Napo Field
You fly north until you can fly no more. Then you land here, in a middle school soccer field.

The air is cool and crisp to the touch. Autumn has come, and the birds will be here soon, stopping in this field on their way south. Or maybe they've already been.

There are some parallel bars in the distance. You could swing from those bars, or climb that barren tree. Or yoo could just keep going north.

>sit down
You are now seated. You feel a pebble beneath your buttock.

>swing bars
I didn't understand that sentence.

>swing
What do you want to swing on?

>bars
You swing around and around and around.

>swing on bars
You swing around and around and around.

>dance
You are now dancing. Life is good.

>dance on bars
You are now dancing on the parallel bars. You spin and you spin, until you can't see straight.

* * *

>n
A Group of Boys
You make your way quickly north, but a group of smiling boys jumps in front of you.

"Kimchi! My name is Bae! Hello! I love you! My name is Chin-ho!"

>look
There is no time. You must leave this place.

A Pavilion
You manage to break away from the group of boys. Running now, panting, you've hardly any time left. Glancing to your right, you see a man helping a yong boy take off his shoes before entering a pavilion.

>n
There is no time. You must leave this place.

Leaving
You're flying now, faster than you've ever flown before... the air that streams by you feels like a thick liquid. Glancing over your shoulder, your last glimpse of Korea is a girl in red stripes, holding an umbrella.

    *** Being There. A notgame for Korea created by Jordan Magnuson. ***

Would you like to RESTART, RESTORE a saved game, or QUIT?

* * *

>n
Sandlot
You follow the stream, walking north, until the stream becomes a river and you can no longer touch the bottom. Then you float with your eyes closed, until the river washes you up on an asphalt shore, where two boys play baseball at dusk.

You feel your time is drawing short. You won't be able to stay here long.

>dance in the sky
You can't see any such thing.

>x sky
You can't see any such thing.

* * *

>n
Sandlot
You follow the stream, walking north, until the stream becomes a river and you can no longer touch the bottom. Then you float with your eyes closed, until the river washes you up on an asphalt shore, where two boys play baseball at dusk.

You feel your time is drawing short. You won't be able to stay here long.

>x sky
The sky is half the world here.

>dance in sky
That's not a verb I recognize.

>touch the sky
It feels like your dreams.

>swim
You take a swim.

>drink water
You can't see any such thing.

* * *

>x sky
The sky is half the world here.

>fly
You are now flying.

>fly in sky
You are now flying in the sky.

* * *

>n
Sandlot
You follow the stream, walking north, until the stream becomes a river and you can no longer touch the bottom. Then you float with your eyes closed, until the river washes you up on an asphalt shore, where two boys play baseball at dusk.

You feel your time is drawing short. You won't be able to stay here long.

>x river
One of the major rivers of South Korea, the Geum is beautiful, and life supporting.

>swim in river
now swiming.

* * *

>n
Sandlot
You follow the stream, walking north, until the stream becomes a river and you can no longer touch the bottom. Then you float with your eyes closed, until the river washes you up on an asphalt shore, where two boys play baseball at dusk.

You feel your time is drawing short. You won't be able to stay here long.

>swim in river
That's not something you can enter.

* * *

>n
Sandlot
You follow the stream, walking north, until the stream becomes a river and you can no longer touch the bottom. Then you float with your eyes closed, until the river washes you up on an asphalt shore, where two boys play baseball at dusk.

You feel your time is drawing short. You won't be able to stay here long.

>swim across river
You dive into the river and swim its full breadth a few times before getting out, and drying off.

>fly
That's not a verb I recognize.

>swim
What do you want to swim in?

>lake
You jump into a lake. Cool water flows over you.

>sit in river
You can't take that position in Geum River.

>stand in river
You can't take that position in Geum River.

* * *

>n
Sandlot
You follow the stream, walking north, until the stream becomes a river and you can no longer touch the bottom. Then you float with your eyes closed, until the river washes you up on an asphalt shore, where two boys play baseball at dusk.

You feel your time is drawing short. You won't be able to stay here long.

>fly
You are now flying.

* * *

>fly in sky
You are now flying in the sky.

>sit
You can't take that position in the sky.

>dance
You are now dancing in the sky. You spin and you spin, until you can't see straight.

* * *

>n
Sandlot
You follow the stream, walking north, until the stream becomes a river and you can no longer touch the bottom. Then you float with your eyes closed, until the river washes you up on an asphalt shore, where two boys play baseball at dusk.

You feel your time is drawing short. You won't be able to stay here long.

>x boys
A group of smiling boys; they look to be in grade school.

>x koreans
You can't see any such thing.

>x korean
A group of smiling boys; they look to be in grade school.

>say hello
(addressing the boys)
The boys turn and look at you. "Hello! Hello!" they shout excitedly.

>n
You can't go that way.

>s
"My name is Bong Cha! My name is Chang Sun!" yell the boys.

Sandlot
You follow the stream, walking south, until the stream becomes a river and you can no longer touch the bottom. Then you float with your eyes closed, until the river washes you up on an asphalt shore, where two boys play baseball at dusk.

You feel your time is drawing short. You won't be able to stay here long.

2

>n
A Group of Boys
You make your way qucikly north, but a group of smiling boys jumps in front of you.

"Kimchi! My name is Bae! Hello! I love you! My name is Chin Ho!"

>n
You can't go that way.

* * *

>n
Sandlot
You follow the stream, walking north, until the stream becomes a river and you can no longer touch the bottom. Then you float with your eyes closed, until the river washes you up on an asphalt shore, where two boys play baseball at dusk.

You feel your time is drawing short. You won't be able to stay here long.

>x air
The sky is half the world here.

>taste air
You open your mouth and breathe in deep. The sky fills your lungs.

* * *

>n
Sandlot
You follow the stream, walking north, until the stream becomes a river and you can no longer touch the bottom. Then you float with your eyes closed, until the river washes you up on an asphalt shore, where two boys play baseball at dusk.

You feel your time is drawing short. You won't be able to stay here long.

>smell sky
Smells like fresh mountain air.

>smell air
Smells like fresh mountain air.

>touch air
It feels like your dreams.

>taste water
Which do you mean, the man-made lakes, or Geum River?

>river
Tastes fresh and earthy... no chlorine here.

* * *

>n
Sandlot
You follow the stream, walking north, until the stream becomes a river and you can no longer touch the bottom. Then you float with your eyes closed, until the river washes you up on an asphalt shore, where two boys play baseball at dusk.

You feel your time is drawing short. You won't be able to stay here long.

>x trees
You can't see any such thing.

>x tree
You can't see any such thing.

>help
That's not a verb I recognize.

* * *

>n
Sandlot
You follow the stream, walking north, until the stream becomes a river and you can no longer touch the bottom. Then you float with your eyes closed, until the river washes you up on an asphalt shore, where two boys play baseball at dusk.

You feel your time is drawing short. You won't be able to stay here long.

When you are ready to leave a location, type "go north," or "go west." Alternately you can just type "leave."

Please press SPACE to continue.

>n
Maisan Mountain
After traveling north for some time you find yourself atop Maisain Mountain, looking out over the farmland of North Jeolla. There's a golf course down there that you might just be able to touch, as well some man-made lakes and Geum River, winding itself towards the Yellow Sea.

You could dance in the sky here, if you wanted. You could probably fly.

* * *

>n
A Pavilion
You manage to break away from the group of boys. Running now, panting, you've hardly any time left. Glancing to your right, you see a man helping a yong boy take off his shoes before entering a pavilion.

>n
Leaving
You're flying now, faster than you've ever flown before... the air that streams by you feels like a thick liquid. Glancing over your shoulder, your last glimpse of Korea is a girl in red stripes, holding an umbrella.

And then she's gone.

           Being There. A notgame for Korea, created by Jordan Magnuson.

* * *

>n
A Stream
You run far this time, and come upon a stream where a father plays with his two daughters.

>x girl
One striped and colorful, one light-colored and polka-dotted, with a skirt.

* * *

>n
Sandlot
You follow the stream, walking north, until the stream becomes a river and you can no longer touch the bottom. Then you float with your eyes closed, until the river washes you up on an asphalt shore, where two boys play baseball at dusk.

You feel your time is drawing short. You won't be able to stay here long.

>x ground
It's the ground.

>x lake
A man-made resevoir built by the Japanese that now serves as a beautiful lake, surrounded by walkways.

>drink
What do you want to drink?

>lake
You can't reach into Maisan Mountain.

>drink water
You can't reach into Maisan Mountain.

>drink water
Time is short: you must leave this place.

* * *

>n
Maisan Mountain
After traveling north for some time you find yourself atop Maisain Mountain, looking out over the farmland of North Jeolla. There's a golf course down there that you might just be able to touch, as well some man-made lakes and Geum River, winding itself towards the Yellow Sea.

You could dance in the sky here, if you wanted. You could probably fly.

>golf
Why not? You grab a stick and play a round of golf, using it as a club.

>play golf
That's not a verb I recognize.

>drink
What do you want to drink?

>water
Which do you mean, the man-made lakes, or Geum River?

>river
Tastes fresh and earthy... no chlorine here.

>smell
Smells surround you...
...fresh mountain air.
...Cis-3-Hexenal... freshly cut grass.
...weeds and fish.
...pine needles.

>climb lake
I don't think much is to be achieved by that.

>swim
What do you want to swim in?

* * *

Blossom Street
A street stretches in front of you. You don't know this street, but it exists. Above you, and all around you, are cherry blossoms: they fill the street gutter; they overflow onto a yellow stripe of paint; they enter your nose, and come out your ears.

You see grass to the left. To the right is a yellow stripe, a streetlight, and a fence.

You could sit here if you wanted. You could run and dance on that yellow stripe. You could lie in the street and let the cherry blossoms bury you. If you wanted.

>n
Maisan Mountain
After traveling north for some time you find yourself atop Maisain Mountain, looking out over the farmland of North Jeolla. There's a golf course down there that you might just be able to touch, as well as some man-made lakes and Geum River, winding itself towards the Yellow Sea.

You could dance in the sky here, if you wanted. You could probably fly.

>fly
You are now flying. You feel millions Nitrogen and Oxygen particles hitting your skin.

>fly in sky
You are now flying in the sky.

>dance
You are now dancing in the sky. You spin and you spin, until you can't see straight.

>dance in water
Which do you mean, the man-made lakes, or Geum River?

>river
(getting out of the sky)
You can't take that position on Geum River.

>swim
What do you want to swim in?

>river
You dive into the river and swim its full breadth a few times before getting out, and drying off.

>play golf
Why not? You grab a stick and play a round of golf, using it as a club.

>golf
Why not? You grab a stick and play a round of golf, using it as a club.

>touch golf
You stretch out a hand, and can just feel the the crisp smooth grass of a green under your fingers.

>stand
You can't take that position on Geum River.

>stand up
You can't take that position on Geum River.

>stand on ground
(getting out of Geum River)
You are now standing on the ground. You feel a breeze behind you.

>climb tree
You climb up a tree for an even better view. But before reaching the top you fall back to the ground.

>swim in sky
(getting out of the ground)
You can't take that position in the sky.

* * *

>n
Maisan Mountain
After traveling north for some time you find yourself atop Maisain Mountain, looking out over the farmland of North Jeolla. There's a golf course down there that you might just be able to touch, as well as some man-made lakes and Geum River, winding itself towards the Yellow Sea.

You could dance in the sky here, if you wanted. You could probably fly.

>n
Napo Field
You fly north until you can fly no more. Then you land here, in a middle school soccer field.

The air is cool and crisp to the touch. Autumn has come, and the birds will be here soon, stopping in this field on their way south. Or maybe they've already been.

There are some parallel bars in the distance. You could swing from those bars, or climb that barren tree. Or you could just keep going north.

>n
Temple Spring
You wander north for hours, searching for you don't know what. And then you find it: A fresh spring at the temple of the nirvana fish, spouting clean, cold water from a bamboo chute.

The water flows onto a stone platform, then over the edge, and away.

>n
Kimchi Pots
Walking north you come upon some gaint Kimchi pots.

If there was kimchi in one of those pots you could eat it... you could put it in your mouth and let the spices soak your tongue.

You could climb into one of the pots and sing until your voice was hoarse.

You could stand on top of one of them and jump up and down until someone made you stop.

You could do a million things. Or nothing at all.

* * *

>n
A Stream
You run far this time, and come upon a stream where a father plays with his two daughters.

>n
Sandlot
You follow the stream, walking north, until the stream becomes a river and you can no longer touch the bottom. Then you float with your eyes closed, until the river washes you up on an asphalt shore, where two boys play baseball at dusk.

You feel your time is drawing short. You won't be able to stay here long.

A man-made resevoir built by the Japanese that now serves as a beautiful lake, surrounded by walkways.

>drink
(Lake Eunpa)
You can't reach into Maisan Mountain.

>sit in lake
You can't take that position on Lake Eunpa.

>swim in resevoir
You dive deep into the lake. Looking up, you see a bright orange sky.

* * *

>n
Kimchi Pots
Walking north you come upon some gaint Kimchi pots.

If there was kimchi in one of those pots you could eat it... you could put it in your mouth and let the spices soak your tongue.

You could climb into one of the pots and sing until your voice was hoarse.

You could stand on top of one of them and jump up and down until someone made you stop.

You could do a million things. Or nothing at all.

>showme it
closed kimchi pot - spot
location: in Kimchi Pots
unlit; inedible; fixed in place; scenery; singular-named; improper-named; neuter; ordinarily enumerated; seen; unfamiliar; unswingable; one-of-many; not drinkable; weak_smelling; soft_sounding
printed name: closed kimchi pot
indefinite article: a
printed plural name: spots
feeling: The pots are glazed, and feel smooth and curvy.
flavor: The pots themselves don't taste like much.
odor: strongly spiced cabbage
sound: pots full of cabbage
enterable
carrying capacity: 100
posture: standing

* * *

>n
Napo Field
You fly north until you can fly no more. Then you land here, in a middle school soccer field.

The air is cool and crisp to the touch. Autumn has come, and the birds will be here soon, stopping in this field on their way south. Or maybe they've already been.

There are some parallel bars in the distance. You could swing from those bars, or climb that barren tree. Or you could just keep going north.

>climb trees
You climb to the top of the barren tree. The field looks distant, and small.

You are now seated in trees. You feel a pebble beneath your buttock.

>l
Napo Field (in trees)
You fly north until you can fly no more. Then you land here, in a middle school soccer field.

The air is cool and crisp to the touch. Autumn has come, and the birds will be here soon, stopping in this field on their way south. Or maybe they've already been.

There are some parallel bars in the distance. You could swing from those bars, or climb that barren tree. Or you could just keep going north.

>sit on field
(getting out of trees)
You are now seated on the middle school soccer field.

>swing on tree
You can't really swing on that.

>dance on tree
(getting off the middle school soccer field)
You climb to the top of the barren tree. The field looks distant, and small.

You can't take that position in trees.

>lie in tree
You are now reclining in trees. Arms outstretched.

>sit in goal
(getting out of trees)
You are now seated in the soccer goal.

>sit on field
(getting out of the soccer goal)
You are now seated on the middle school soccer field. Cross-legged.

>stand in goal
(getting off the middle school soccer field)
You are now standing in the soccer goal. You feel a breeze behind you.

>sing in goal
You are now singing in the soccer goal. You belt it out like a good one.

>sing
You are already singing.

>sit down
You are now seated in the soccer goal. Legs out in front of you.

>play football
In Korea, they actually call it "soccer."

You play soccer with an invisible ball... you score!

>fly
You can't take that position in the soccer goal.

>fly in sky
(getting out of the soccer goal)
You are now flying in the sky.

>d
You lower yourself down, getting as close as you can to the earth.

>fly
You are now flying. You feel millions of Nitrogen and Oxygen particles hitting your skin.

>l
Napo Field
You fly north until you can fly no more. Then you land here, in a middle school soccer field.

The air is cool and crisp to the touch. Autumn has come, and the birds will be here soon, stopping in this field on their way south. Or maybe they've already been.

There are some parallel bars in the distance. You could swing from those bars, or climb that barren tree. Or you could just keep going north.

>d
But you aren't in anything at the moment.
You lower yourself down, getting as close as you can to the earth.

* * *

>n
Maisan Mountain
After traveling north for some time you find yourself atop Maisain Mountain, looking out over the farmland of North Jeolla. There's a golf course down there that you might just be able to touch, as well as some man-made lakes and Geum River, winding itself towards the Yellow Sea.

You could dance in the sky here, if you wanted. You could probably fly.

>z
The cherry blossoms pile higher.

* * *

>z
Time passes.

>z
The cherry blossoms pile higher still.

>z
Time passes.

* * *

Blossom Street
A street stretches in front of you. You don't know this street, but it exists. Above you, and all around you, are cherry blossoms: they fill the street gutter; they overflow onto a yellow stripe of paint; they enter your nose, and come out your ears.

You see grass to the left. To the right is a yellow stripe, a streetlight, and a fence.

You could sit here if you wanted. You could run and dance on that yellow stripe. You could lie in the street and let the cherry blossoms bury you. If you wanted.

>fly
You are now flying. You feel millions of Nitrogen and Oxygen particles hitting your skin.

>d
You lower yourself down, getting as close as you can to the earth.

>l
Blossom Street
A street stretches in front of you. You don't know this street, but it exists. Above you, and all around you, are cherry blossoms: they fill the street gutter; they overflow onto a yellow stripe of paint; they enter your nose, and come out your ears.

You see grass to the left. To the right is a yellow stripe, a streetlight, and a fence.

You could sit here if you wanted. You could run and dance on that yellow stripe. You could lie in the street and let the cherry blossoms bury you. If you wanted.

>fly in sky
You are now flying in the sky. You feel a breeze behind you.

>l
Blossom Street (in the sky)
A street stretches in front of you. You don't know this street, but it exists. Above you, and all around you, are cherry blossoms: they fill the street gutter; they overflow onto a yellow stripe of paint; they enter your nose, and come out your ears.

You see grass to the left. To the right is a yellow stripe, a streetlight, and a fence.

You could sit here if you wanted. You could run and dance on that yellow stripe. You could lie in the street and let the cherry blossoms bury you. If you wanted.

>d
You lower yourself down, getting as close as you can to the earth.

>sit down
You can't take that position in the sky.

>get out of the sky
I only understood the first part of that-- trying anyway.

(retrying as if you'd typed "get out.")
You get out of the sky.

Blossom Street
A street stretches in front of you. You don't know this street, but it exists. Above you, and all around you, are cherry blossoms: they fill the street gutter; they overflow onto a yellow stripe of paint; they enter your nose, and come out your ears.

You see grass to the left. To the right is a yellow stripe, a streetlight, and a fence.

You could sit here if you wanted. You could run and dance on that yellow stripe. You could lie in the street and let the cherry blossoms bury you. If you wanted.

* * *

>n
Temple Spring
You wander north for hours, searching for you don't know what. And then you find it: a fresh spring at the temple of the nirvana fish, spouting clean, cold water from a bamboo shoot.

The water flows onto a stone platform, then over the edge, and away.

You can see a cup here.

>drink
(the water)
Ignoring the cups, you place your mouth to the fountain, and drink for a long moment. The water freezes your lips and chin, but it tastes like heaven.

* * *

>n
Kimchi Pots
Walking north you come upon some gaint Kimchi pots.

If there was kimchi in one of those pots you could eat it... you could put it in your mouth and let the spices soak your tongue.

You could climb into one of the pots and sing until your voice was hoarse.

You could stand on top of one of them and jump up and down until someone made you stop.

You could do a million things. Or nothing at all.

>eat kimchi
You need to open the pot first.

>eat
You need to open the pot first.

>open pot
You open a kimchi pot, revealing more kimchi than you know what to do with.

>eat
What do you want to eat?

>kimchi
You take a bite of the kimchi. Spicy and delicious.

>eat pot
Pretty much what you would expect.

>eat more
A lot of words like prepositions and adverbs are not necessary in interactive fiction.

(retrying as if you'd typed "eat .")
What do you want to eat?

>eat more kimchi
A lot of words like prepositions and adverbs are not necessary in interactive fiction.

(retrying as if you'd typed "eat  kimchi.")
You take another bite.

>eat kimchi
You eat more. And more. You're starting to get addicted.

>eat more
A lot of words like prepositions and adverbs are not necessary in interactive fiction.

(retrying as if you'd typed "eat .")
What do you want to eat?

>eat more kimchi
A lot of words like prepositions and adverbs are not necessary in interactive fiction.

(retrying as if you'd typed "eat  kimchi.")
Okay, you're officially addicted.

>eat more
A lot of words like prepositions and adverbs are not necessary in interactive fiction.

(retrying as if you'd typed "eat .")
What do you want to eat?

>lick
What do you want to lick?

>kimchi
Okay, you're officially addicted.

>eat more kimchi
A lot of words like prepositions and adverbs are not necessary in interactive fiction.

(retrying as if you'd typed "eat  kimchi.")
Okay, you're officially addicted.

* * *

>n
Napo Field
You fly north until you can fly no more. Then you land here, in a middle school soccer field.

The air is cool and crisp to the touch. Autumn has come, and the birds will be here soon, stopping in this field on their way south. Or maybe they've already been.

There are some parallel bars in the distance. You could swing from those bars, or climb that barren tree. Or yoo could just keep going north.

>play soccer
Which do you mean, the middle school soccer field, or the soccer goal?

>soccer goal
You play soccer.

>x soccer
Which do you mean, the middle school soccer field, or the soccer goal?

>play goal
You play soccer.

* * *

>stop playing
You can't see any such thing.

* * *

>dance
You are now dancing. You feel a breeze behind you.

>stop dancing
You can't see any such thing.

>stop goal
Okay, you've stopped.

* * *

Blossom Street
A street stretches in front of you. You don't know this street, but it exists. Above you, and all around you, are cherry blossoms: they fill the street gutter; they overflow onto a yellow stripe of paint; they enter your nose, and come out your ears.

You see grass to the left. To the right is a yellow stripe, a streetlight, and a fence.

You could sit here if you wanted. You could run and dance on that yellow stripe. You could lie in the street and let the cherry blossoms burry you. If you wanted.

>n
Maisan Mountain
After traveling north for some time you find yourself atop Maisain Mountain, looking out over the farmland of North Jeolla. There's a golf course down there that you might just be able to touch, as well some man-made lakes and Geum River, winding itself towards the Yellow Sea.

You could dance in the sky here, if you wanted. You could probably fly.

>fly in sky
You are now flying on the sky. You feel millions Nitrogen and Oxygen particles hitting your skin.

* * *

Blossom Street
A street stretches in front of you. You don't know this street, but it exists. Above you, and all around you, are cherry blossoms: they fill the street gutter; they overflow onto a yellow stripe of paint; they enter your nose, and come out your ears.

You see grass to the left. To the right is a yellow stripe, a streetlight, and a fence.

You could sit here if you wanted. You could run and dance on that yellow stripe. You could lie in the street and let the cherry blossoms burry you. If you wanted.

>fly
You are now flying. You feel millions Nitrogen and Oxygen particles hitting your skin.

* * *

>fly in sky
You are now flying in the sky.

>s
(first leaving the sky)

Being There

During the course of play you will be taken to a series of locations. In each location you can do various things by typing commands into the text prompt. Try things like:

listen
examine the stripe
touch the street
dance on the sidewalk
climb the tree
taste the flower

Please press SPACE to continue.

* * *

>n
Maisan Mountain
After traveling north for some time you find yourself atop Maisain Mountain, looking out over the farmland of North Jeolla. There's a golf course down there that you might just be able to touch, as well some man-made lakes and Geum River, winding itself towards the Yellow Sea.

You could dance in the sky here, if you wanted. You could probably fly.

>fly in sky
You are now flying on the sky. You feel a breeze behind you.

* * *

>n
Kimchi Pots
Walking north you come upon some gaint Kimchi pots.

If there was kimchi in one of those pots you could eat it... you could put it in your mouth and let the spices soak your tongue.

You could climb into one of the pots and sing until your voice was hoarse.

You could stand on top of one of them and jump up and down until someone made you stop.

You could do a million things. Or nothing at all.

>eat
What do you want to eat?

>kimchi
You can't see any such thing.

>eat kimchi
You can't see any such thing.

>take kimchi
You can't see any such thing.

* * *

>n
Sandlot
You follow the stream, walking north, until the stream becomes a river and you can no longer touch the bottom. Then you float with your eyes closed, until the river washes you up on an asphalt shore, where two boys play baseball at dusk.

You feel your time is drawing short. You won't be able to stay here long.

>x ball
Just your ordinary baseball.

>take ball
That seems to belong to the baseball players.

* * *

>n
Sandlot
You follow the stream, walking north, until the stream becomes a river and you can no longer touch the bottom. Then you float with your eyes closed, until the river washes you up on an asphalt shore, where two boys play baseball at dusk.

You feel your time is drawing short. You won't be able to stay here long.

>take bat
Through pantomime you demonstrate to the boys that you are an exceptional baseball player. They gladly let you join in, and you play for some time.

>take ball
That seems to belong to the baseball players.

>x ball
Just your ordinary baseball.

* * *

>n
Sandlot
You follow the stream, walking north, until the stream becomes a river and you can no longer touch the bottom. Then you float with your eyes closed, until the river washes you up on an asphalt shore, where two boys play baseball at dusk.

You feel your time is drawing short. You won't be able to stay here long.

>take ball
Through pantomime you demonstrate to the boys that you are an exceptional baseball player. They gladly let you join in, and you play for some time.

>x stairs
Designed to look like wood, these stairs are actually made of hard plastic. Where do they lead to?

>look at stairs
Designed to look like wood, these stairs are actually made of hard plastic. Where do they lead to?

>climb stairs
You can't take that position on the stairs.

* * *

>n
Sandlot
You follow the stream, walking north, until the stream becomes a river and you can no longer touch the bottom. Then you float with your eyes closed, until the river washes you up on an asphalt shore, where two boys play baseball at dusk.

You feel your time is drawing short. You won't be able to stay here long.

>stand on stairs
You are now standing on the stairs. You imagine that you are a needle, pointed towards the sky.

>stand
You continue to stand. A beam of sunlight crosses in front of you.

>sit
You are now seated on the stairs. Cross-legged.

>l
Sandlot (on the stairs)
An asphalt lot, where two boys play baseball at dusk.

>dance
You are now dancing on the stairs.

>run
You are now running on the stairs. The ether shifts around you.

>walk
You are now walking on the stairs.

>walk
You continue to walk. You feel a breeze behind you.

>lie on stairs
You are now reclining on the stairs. The earth spins slowly.

>sing
You are now singing on the stairs. You belt it out like a good one.

>fly
(getting off the stairs)
You are now flying in the sky. Like the fastest things on earth.

>dive
You soar up, and then down, twirling and gliding like you were born to do it.

>get down
You get out of the sky.

Sandlot
An asphalt lot, where two boys play baseball at dusk.

>climb stairs
You are now climbing on the stairs. You close your eyes for a moment... and almost fall asleep.

* * *

>n
Sandlot
You follow the stream, walking north, until the stream becomes a river and you can no longer touch the bottom. Then you float with your eyes closed, until the river washes you up on an asphalt shore, where two boys play baseball at dusk.

You feel your time is drawing short. You won't be able to stay here long.

>climb stairs
You climb the stairs to find yourself at the edge of Lake Eunpa, a man-made resevoir built by the Japanese that now serves as a beautiful lake, surrounded by walkways.

>x lake
You see nothing special about Lake Eunpa.

>x walkways
You see nothing special about the walkways.

>walk on walkways
You are now walking on the walkways.

>walk
You continue to walk. A beam of sunlight crosses in front of you.

>walk
You continue to walk. The world looks different.

>walk
You continue to walk.

>l
Sandlot (on the walkways)
An asphalt lot, where two boys play baseball at dusk.

>swim
What do you want to swim in?

>lake
(getting off the walkways)

Looking up, you see a bright orange sky.

>l
Sandlot (in Lake Eunpa)
An asphalt lot, where two boys play baseball at dusk.

>swim
What do you want to swim in?

>lake
You wonder how you ended up here.

Looking up, you see a bright orange sky.

* * *

>n
Sandlot
You follow the stream, walking north, until the stream becomes a river and you can no longer touch the bottom. Then you float with your eyes closed, until the river washes you up on an asphalt shore, where two boys play baseball at dusk.

You feel your time is drawing short. You won't be able to stay here long.

>swim inlake
I didn't understand that sentence.

>swim in lake
Above you is the sky.

Looking up, you see a bright orange sky.

* * *

>n
Sandlot
You follow the stream, walking north, until the stream becomes a river and you can no longer touch the bottom. Then you float with your eyes closed, until the river washes you up on an asphalt shore, where two boys play baseball at dusk.

You feel your time is drawing short. You won't be able to stay here long.

>drink lake
Tastes fresh and earthy... no chlorine here.

>drink
(Lake Eunpa)
Tastes fresh and earthy... no chlorine here.

>swim
(in Lake Eunpa)

Just like when you were a kid... or maybe not.

* * *

>n
Sandlot
You follow the stream, walking north, until the stream becomes a river and you can no longer touch the bottom. Then you float with your eyes closed, until the river washes you up on an asphalt shore, where two boys play baseball at dusk.

You feel your time is drawing short. You won't be able to stay here long.

>swim
(in Lake Eunpa)
You dive into the water head first, then gradually allow yourself to turn over. Looking up, you see a bright orange sky.

>swim
(in Lake Eunpa)
You swim around some more.

>swim in lake
You swim around some more.

>l
Sandlot (in Lake Eunpa)
An asphalt lot, where two boys play baseball at dusk.

>fly
(getting out of Lake Eunpa)
You are now flying in the sky. Like a plane.

>fly in water
You are now flying in the sky. You hit a hot air patch and shoot upwards geyser style.

>climb stairs
You climb the stairs to find yourself at the edge of Lake Eunpa, a man-made resevoir built by the Japanese that now serves as a beautiful lake, surrounded by walkways.

>x stairs
Designed to look like wood, these stairs are actually made of hard plastic. Where do they lead to?

>take bat
Through pantomime you demonstrate to the boys that you are an exceptional baseball player. They gladly let you join in, and you play for some time.

>play baseball
Through pantomime you demonstrate to the boys that you are an exceptional baseball player. They gladly let you join in, and you play for some time.

>play
Through pantomime you demonstrate to the boys that you are an exceptional baseball player. They gladly let you join in, and you play for some time.

>listen
You hear...
...the buzz of insects.
...wind in a large, large space.

>x gravel
You can't see any such thing.

>talk to boys
The boys turn and look at you. "Hello! Hello!" they shout excitedly.

>talk to boys
"My name is Bong-cha! My name is Chang-sun!" yell the boys.

>talk
What do you want to talk to?

>boys
The boys seem focused on their baseball playing.

>look
Sandlot (in the sky)
An asphalt lot, where two boys play baseball at dusk.

>n
(first leaving the sky)

A Group of Boys
You make your way quickly north, but a group of smiling boys jumps in front of you.

"Kimchi! My name is Bae! Hello! I love you! My name is Chin-ho!"

>talk
What do you want to talk to?

>boys
Hello! How are you! My name is Bon-hwa! yell the boys, excitedly.

>say hello
There is no more time to spare: you must keep moving.

* * *

>stand on stripe
You stand on the yellow stripe of paint.

Blossom Street (on the yellow stripe of paint)
A street stretches in front of you. You don't know this street, but it exists. Above you, and all around you, are cherry blossoms: they fill the street gutter; they overflow onto a yellow stripe of paint; they enter your nose, and come out your ears.

You see grass to the left. To the right is a yellow stripe, a streetlight, and a fence.

You could sit here if you wanted. You could run and dance on that yellow stripe. You could lie in the street and let the cherry blossoms burry you. If you wanted.

>sit on road
You sit on the road.

Blossom Street (on the road)
A street stretches in front of you. You don't know this street, but it exists. Above you, and all around you, are cherry blossoms: they fill the street gutter; they overflow onto a yellow stripe of paint; they enter your nose, and come out your ears.

You see grass to the left. To the right is a yellow stripe, a streetlight, and a fence.

You could sit here if you wanted. You could run and dance on that yellow stripe. You could lie in the street and let the cherry blossoms burry you. If you wanted.

>sit in gutter
You sit in the gutter.

Blossom Street (in the gutter)
A street stretches in front of you. You don't know this street, but it exists. Above you, and all around you, are cherry blossoms: they fill the street gutter; they overflow onto a yellow stripe of paint; they enter your nose, and come out your ears.

You see grass to the left. To the right is a yellow stripe, a streetlight, and a fence.

You could sit here if you wanted. You could run and dance on that yellow stripe. You could lie in the street and let the cherry blossoms burry you. If you wanted.

>sit behind road
You sit behind the road.

>sit under road
You sit under the road.

>sit in gutter
You sit in the gutter.

Blossom Street (in the gutter)
A street stretches in front of you. You don't know this street, but it exists. Above you, and all around you, are cherry blossoms: they fill the street gutter; they overflow onto a yellow stripe of paint; they enter your nose, and come out your ears.

You see grass to the left. To the right is a yellow stripe, a streetlight, and a fence.

You could sit here if you wanted. You could run and dance on that yellow stripe. You could lie in the street and let the cherry blossoms burry you. If you wanted.

>sit in road
You can't sit in the road.

>sit on road
You sit on the road.

Blossom Street (on the road)
A street stretches in front of you. You don't know this street, but it exists. Above you, and all around you, are cherry blossoms: they fill the street gutter; they overflow onto a yellow stripe of paint; they enter your nose, and come out your ears.

You see grass to the left. To the right is a yellow stripe, a streetlight, and a fence.

You could sit here if you wanted. You could run and dance on that yellow stripe. You could lie in the street and let the cherry blossoms burry you. If you wanted.

>sit on road
You sit on the road.

Blossom Street (on the road)
A street stretches in front of you. You don't know this street, but it exists. Above you, and all around you, are cherry blossoms: they fill the street gutter; they overflow onto a yellow stripe of paint; they enter your nose, and come out your ears.

You see grass to the left. To the right is a yellow stripe, a streetlight, and a fence.

You could sit here if you wanted. You could run and dance on that yellow stripe. You could lie in the street and let the cherry blossoms burry you. If you wanted.

* * *

>lie on road
You lie down on your back in the middle of the street, and open your mouth. Cherry blossoms rain down like snow, and settle on your legs, your torso, your fingertips.

>lie on road
You lie down on your back in the middle of the street, and open your mouth. Cherry blossoms rain down like snow, and settle on your legs, your torso, your fingertips.

* * *

>lie on sidewalk
You lie on the sidewalk.

Blossom Street (on the sidewalk)
A street stretches in front of you. You don't know this street, but it exists. Above you, and all around you, are cherry blossoms: they fill the street gutter; they overflow onto a yellow stripe of paint; they enter your nose, and come out your ears.

You see grass to the left. To the right is a yellow stripe, a streetlight, and a fence.

You could sit here if you wanted. You could run and dance on that yellow stripe. You could lie in the street and let the cherry blossoms burry you. If you wanted.

>taste sidewalk
It tastes like the blossoms that cover it: earthy, but sweet.

>listen
You hear...
Every stripe you've never listened to.
Nature busilly going about its business.
A distant stream.
sNow.

* * *

Being There

During the course of play you will be taken to a series of locations. In each location you can do various things by typing commands into the text prompt. Try things like:

listen
examine the stripe
touch the street
dance on the sidewalk
climb the tree
taste the flower

Please press SPACE to continue.

>sit
You are now seated. You feel a pebble beneath your buttock.

>sit on road
You are now seated on the road. Cross-legged.

>n
(first leaving the road)

Maisan Mountain
After traveling north for some time you find yourself atop Maisain Mountain, looking out over the farmland of North Jeolla. There's a golf course down there that you might just be able to touch, as well some man-made lakes and Geum River, winding itself towards the Yellow Sea.

You could dance in the sky here, if you wanted. You could probably fly.

>n
Napo Field
You fly north until you can fly no more. Then you land here, in a middle school soccer field.

The air is cool and crisp to the touch. Autumn has come, and the birds will be here soon, stopping over on their way south. Or maybe they've already left.

There are some parallel bars in the distance. You could sing on the field, or dance on those bars, or climb that barren tree. Or yoo could just keep going north.

* * *

>s
Blossom Street
A street stretches in front of you. You don't know this street, but it exists. Above you, and all around you, are cherry blossoms: they fill the street gutter; they overflow onto a yellow stripe of paint; they enter your nose, and come out your ears.

You see grass to the left. To the right is a yellow stripe, a streetlight, and a fence.

You could sit here if you wanted. You could run and dance on that yellow stripe. You could lie in the street and let the cherry blossoms burry you. If you wanted.

>s
You can't go that way.

>n
Maisan Mountain
After traveling north for some time you find yourself atop Maisain Mountain, looking out over the farmland of North Jeolla. There's a golf course down there that you might just be able to touch, as well some man-made lakes and Geum River, winding itself towards the Yellow Sea.

You could dance in the sky here, if you wanted. You could probably fly.

* * *

>n
Kimchi Pots
Walking north you come upon some gaint Kimchi pots.

If there was kimchi in one of those pots you could eat it... you could put it in your mouth and let the spices soak your tongue.

You could climb into one of the pots and sing until your voice was hoarse.

You could stand on top of one of them and jump up and down until somebody made you stop.

You could do a million things. Or nothing at all.

>n
You can't go that way.

>s
Temple Spring
You wander south for hours, searching for you don't know what. And then you find it: a fresh spring at the temple of the nirvana fish, spouting clean, cold water from a bamboo shoot.

* * *

>n
Napo Field
You fly north until you can fly no more. Then you land here, in a middle school soccer field.

The air is cool and crisp to the touch. Autumn has come, and the birds will be here soon, stopping over on their way south. Or maybe they've already left.

There are some parallel bars in the distance. You could sing on the field, or dance on those bars, or climb that barren tree. Or yoo could just keep going north.

>s
Maisan Mountain
After traveling south for some time you find yourself atop Maisain Mountain, looking out over the farmland of North Jeolla. There's a golf course down there that you might just be able to touch, as well some man-made lakes and Geum River, winding itself towards the Yellow Sea.

You could dance in the sky here, if you wanted. You could probably fly.

* * *

>n
Maisan Mountain
After traveling north for some time you find yourself atop Maisain Mountain, looking out over the farmland of North Jeolla. There's a golf course down there that you might just be able to touch, as well some man-made lakes and Geum River, winding itself towards the Yellow Sea.

You could dance in the sky here, if you wanted. You could probably fly.

>s
Blossom Street

>n
Maisan Mountain
Irrigation is what it's all about in these plains.

One of the major rivers of South Korea, the Geum is beautiful, and life supporting.

>n
Napo Field

>s
Maisan Mountain
Irrigation is what it's all about in these plains.

One of the major rivers of South Korea, the Geum is beautiful, and life supporting.

>s
Blossom Street

* * *

Being There

During the course of play you will be taken to a series of locations. In each location you can do various things by typing commands into the text prompt. Try things like:

listen
examine the stripe
touch the street
dance on the sidewalk
climb the tree
taste the flower

Please press SPACE to continue.

>sing
You are now singing.

>n
Maisan Mountain
After traveling north for some time you find yourself atop Maisain Mountain, looking out over the farmland of North Jeolla. There's a golf course down there that you might just be able to touch, as well some man-made lakes and Geum River, winding itself towards the Yellow Sea.

You could dance in the sky here, if you wanted. You could probably fly.

* * *

>n
Napo Field
You fly north until you can fly no more. Then you land here, in a middle school soccer field.

The air is cool and crisp to the touch. Autumn has come, and the birds will be here soon, stopping in this field on their way south. Or maybe they've already been.

There are some parallel bars in the distance. You could swing from those bars, or climb that barren tree. Or yoo could just keep going north.

>x field
You see nothing special about the soccer field.

>x soccer
You see nothing special about the soccer field.

>x football field
You see nothing special about the soccer field.

>dance on field
You are now dancing on the soccer field. You spin and you spin, until you can't see straight.

* * *

>sing
You are now singing.

>sing
You are already singing.

>sing
You are already singing.

>stand up
You are now standing. You feel tall.

* * *

>sing
You are already singing.

>ing
That's not a verb I recognize.

>sing
You are already singing.

>fly
You are now flying. You feel millions Nitrogen and Oxygen particles hitting your skin.

>fly
You are already flying.

>fly
You are already flying.

>ly
That's not a verb I recognize.

>fly
You are already flying.

>sing
You are now singing. You belt it out like a good one.

>sing and dance
I only understood you as far as wanting to sing.

>dance on fence
That's not something you can enter.

* * *

Being There

During the course of play you will be taken to a series of locations. In each location you can do various things by typing commands into the text prompt. Try things like:

listen
examine the stripe
touch the street
dance on the sidewalk
climb the tree
taste the flower

Please press SPACE to continue.

>lie in street
You lie down on your back in the middle of the street, and open your mouth. Cherry blossoms rain down like snow, and settle on your legs, your torso, your fingertips.

>lie on street
You lie down on your back in the middle of the street, and open your mouth. Cherry blossoms rain down like snow, and settle on your legs, your torso, your fingertips.

* * *

Being There

During the course of play you will be taken to a series of locations. In each location you can do various things by typing commands into the text prompt. Try things like:

listen
examine the stripe
touch the street
dance on the sidewalk
climb the tree
taste the flower

Please press SPACE to continue.

>sing on road
You can't take that position on the road.

* * *

Being There

During the course of play you will be taken to a series of locations. In each location you can do various things by typing commands into the text prompt. Try things like:

listen
examine the stripe
touch the street
dance on the sidewalk
climb the tree
taste the flower

Please press SPACE to continue.

>sing on stripe
You are now singing on the yellow stripe of paint.

>sing
What do you want to sing on?

* * *

Being There

During the course of play you will be taken to a series of locations. In each location you can do various things by typing commands into the text prompt. Try things like:

listen
examine the stripe
touch the street
dance on the sidewalk
climb the tree
taste the flower

Please press SPACE to continue.

>sing down
I only understood you as far as wanting to sing.

>sing
You are now singing. You feel a breeze behind you.

>sing on road
You can't take that position on the road.

>sing on stripe
(getting off the road)
You are now singing on the yellow stripe of paint.

>n
(first leaving the yellow stripe of paint)

Maisan Mountain
After traveling north for some time you find yourself atop Maisain Mountain, looking out over the farmland of North Jeolla. There's a golf course down there that you might just be able to touch, as well some man-made lakes and Geum River, winding itself towards the Yellow Sea.

You could dance in the sky here, if you wanted. You could probably fly.

* * *

Being There

During the course of play you will be taken to a series of locations. In each location you can do various things by typing commands into the text prompt. Try things like:

listen
examine the stripe
touch the street
dance on the sidewalk
climb the tree
taste the flower

Please press SPACE to continue.

>x nose
You see nothing special about your nose.

>x foot
You can't see any such thing.

* * *

Being There

During the course of play you will be taken to a series of locations. In each location you can do various things by typing commands into the text prompt. Try things like:

listen
examine the stripe
touch the street
dance on the sidewalk
climb the tree
taste the flower

Please press SPACE to continue.

>x fingers
You see nothing special about your fingers.

>x hand
You see nothing special about your hand.

>x fingers
You see nothing special about your fingers.

>x finger
You see nothing special about your fingers.

>x ear
You can't see any such thing.

>x hand
You see nothing special about your hand.

>x hands
You see nothing special about your hands.

>x fingers
You see nothing special about your fingers.

>x legs
You see nothing special about your legs.

* * *

Being There

During the course of play you will be taken to a series of locations. In each location you can do various things by typing commands into the text prompt. Try things like:

listen
examine the stripe
touch the street
dance on the sidewalk
climb the tree
taste the flower

Please press SPACE to continue.

>x ear
You can't see any such thing.

>x cherr
You can't see any such thing.

>x cherry
The cherry blossoms are everywhere, in everything. Fluffy and white like snow, but without the cold.

>x cherry trees
I only understood you as far as wanting to examine the cherry blossoms.

>>x cherry tree
That's not a verb I recognize.

>x tree
The indigenous cherry blossom trees bloom once a year in Korea, and only for a week.

>x cherry tree
The indigenous cherry blossom trees bloom once a year in Korea, and only for a week.

* * *

Being There

During the course of play you will be taken to a series of locations. In each location you can do various things by typing commands into the text prompt. Try things like:

listen
examine the stripe
touch the street
dance on the sidewalk
climb the tree
taste the flower

Please press SPACE to continue.

>x football
In Korea, they actually call it "soccer."
You can't see any such thing.

>n
Maisan Mountain
After traveling north for some time you find yourself atop Maisain Mountain, looking out over the farmland of North Jeolla. There's a golf course down there that you might just be able to touch, as well some man-made lakes and Geum River, winding itself towards the Yellow Sea.

You could dance in the sky here, if you wanted. You could probably fly.

* * *

>n
Napo Field
You fly north until you can fly no more. Then you land here, in a middle school soccer field.

The air is cool and crisp to the touch. Autumn has come, and the birds will be here soon, stopping in this field on their way south. Or maybe they've already been.

There are some parallel bars in the distance. You could swing from those bars, or climb that barren tree. Or yoo could just keep going north.

>x football
In Korea, they actually call it "soccer."
You can't see any such thing.

>x football field
In Korea, they actually call it "soccer."

Most Korean soccer fields are worn to dirt. This one is surprisingly well-carpeted.

>n
Temple Spring
You wander north for hours, searching for you don't know what. And then you find it: a fresh spring at the temple of the nirvana fish, spouting clean, cold water from a bamboo shoot.

>drink
(the water)
There's nothing suitable to drink here.

>water
That's not a verb I recognize.

* * *

Being There

During the course of play you will be taken to a series of locations. In each location you can do various things by typing commands into the text prompt. Try things like:

listen
examine the stripe
touch the street
dance on the sidewalk
climb the tree
taste the flower

Please press SPACE to continue.

>use blossom
Which do you mean, the cherry blossoms, or the cherry blossom trees?

>cherry blossoms
There are too many to carry.

>n
Maisan Mountain
After traveling north for some time you find yourself atop Maisain Mountain, looking out over the farmland of North Jeolla. There's a golf course down there that you might just be able to touch, as well some man-made lakes and Geum River, winding itself towards the Yellow Sea.

You could dance in the sky here, if you wanted. You could probably fly.

* * *

>n
Napo Field
You fly north until you can fly no more. Then you land here, in a middle school soccer field.

The air is cool and crisp to the touch. Autumn has come, and the birds will be here soon, stopping in this field on their way south. Or maybe they've already been.

There are some parallel bars in the distance. You could swing from those bars, or climb that barren tree. Or yoo could just keep going north.

>n
Temple Spring
You wander north for hours, searching for you don't know what. And then you find it: a fresh spring at the temple of the nirvana fish, spouting clean, cold water from a bamboo shoot.

You can see a cup here.

>use cup with water
I only understood you as far as wanting to use the cup.

>use cup
You take one of the cups and dip it into the stream of water; then you drink a long draught.

>drink cup
You take one of the cups and dip it into the stream of water; then you drink a long draught.

>drink from srping
You can't see any such thing.

>drink from spring
You can't see any such thing.

>drink spring
Ignoring the cups, you place your mouth to the fountain, and drink for a long moment. The water freezes your lips and chin, but it tastes like heaven.

>drink from water
You can't see any such thing.

>drink from spring
You can't see any such thing.

>drink spring water
Ignoring the cups, you place your mouth to the fountain, and drink for a long moment. The water freezes your lips and chin, but it tastes like heaven.

>x bamboo
Tubes made from bamboo.

>x tubes
Tubes made from bamboo.

* * *

Being There

During the course of play you will be taken to a series of locations. In each location you can do various things by typing commands into the text prompt. Try things like:

listen
examine the stripe
touch the street
dance on the sidewalk
climb the tree
taste the flower

Please press SPACE to continue.

>climb into street
You get onto the road.

>n
(first leaving the road)

Maisan Mountain
After traveling north for some time you find yourself atop Maisain Mountain, looking out over the farmland of North Jeolla. There's a golf course down there that you might just be able to touch, as well some man-made lakes and Geum River, winding itself towards the Yellow Sea.

You could dance in the sky here, if you wanted. You could probably fly.

>n
Napo Field
You fly north until you can fly no more. Then you land here, in a middle school soccer field.

The air is cool and crisp to the touch. Autumn has come, and the birds will be here soon, stopping in this field on their way south. Or maybe they've already been.

There are some parallel bars in the distance. You could swing from those bars, or climb that barren tree. Or yoo could just keep going north.

* * *

>n
Kimchi Pots
Walking north you come upon some gaint Kimchi pots.

If there was kimchi in one of those pots you could eat it... you could put it in your mouth and let the spices soak your tongue.

You could climb into one of the pots and sing until your voice was hoarse.

You could stand on top of one of them and jump up and down until someone made you stop.

You could do a million things. Or nothing at all.

>climb into pot
You can't get into the closed pot.

>open pot
You open the pot, revealing a small mountain of kimchi.

>climb into pot
You get into the pot.

In the pot you can see a small mountain of kimchi.

>get out of pot
I only understood you as far as wanting to get outside.

* * *

Being There

During the course of play you will be taken to a series of locations. In each location you can do various things by typing commands into the text prompt. Try things like:

listen
examine the stripe
touch the street
dance on the sidewalk
climb the tree
taste the flower

Please press SPACE to continue.

>x suit
You can't see any such thing.

>x swimsuit
From the shape of the suit and a bit of carrying strap emerging from the pocket, you can see the man's packing a camera--ready to capture any Kodak moments, if he can manage to get his hands free.

* * *

>x suit
You can't see any such thing.

>x swimsiut
You can't see any such thing.

* * *

Being There

During the course of play you will be taken to a series of locations. In each location you can do various things by typing commands into the text prompt. Try things like:

listen
examine the stripe
touch the street
dance on the sidewalk
climb the tree
taste the flower

Please press SPACE to continue.

>x swimsuit
From the shape of the suit and a bit of carrying strap emerging from the pocket, you can see the man's packing a camera--ready to capture any Kodak moments, if he can manage to get his hands free.

>x towel
You see nothing special about the towel.

>x tshirt
You see nothing special about the blue T-shirt.

>x shirt
You see nothing special about the blue T-shirt.

>x man
A middle aged Korean man, having fun with his daughters.

>x head
You can't see any such thing.

>x visors
Koreans are typically very concerned about sun exposure, for health reasons, and because they tend to prefer light skin.

>x visor
You can't see any such thing.

* * *

Being There

During the course of play you will be taken to a series of locations. In each location you can do various things by typing commands into the text prompt. Try things like:

listen
examine the stripe
touch the street
dance on the sidewalk
climb the tree
taste the flower

Please press SPACE to continue.

>x stream
A clear flowing stream that's just calling out to you to sit down in it and ponder life for a while.

>sit in stream
You are now seated in the stream. You feel a pebble beneath your buttock.

>lie in stream
You are now reclining in the stream.

>swim in stream
Some might say the water's a bit shallow for swimming, but that doesn't stop you from diving in head first and splashing about like a maniac.

>drink stream
You bend down, place your head in the stream, and open your mouth. The water rushes into mouth, down your throat, and fills your stomach.

* * *

Being There

During the course of play you will be taken to a series of locations. In each location you can do various things by typing commands into the text prompt. Try things like:

listen
examine the stripe
touch the street
dance on the sidewalk
climb the tree
taste the flower

Please press SPACE to continue.

>drink water
You bend down, place your head in the stream, and open your mouth. The water rushes into your mouth, down your throat, and fills your stomach. Bloated, you fall over with a splash. You are now reclining in the stream.

>drink
(the stream)
You bend down, place your head in the stream, and open your mouth. The water rushes into mouth, down your throat, and fills your stomach.

A Stream (in the stream)
You run far this time, and come upon a stream where a father plays with his two daughters.

You can see a Korean man and a Korean girls here.

>dance in stream
You are now dancing in the stream.

>stand up
You are now standing in the stream. You feel tall.

>s
(first leaving the stream)

Kimchi Pots
Walking south you come upon some gaint Kimchi pots.

If there was kimchi in one of those pots you could eat it... you could put it in your mouth and let the spices soak your tongue.

You could climb into one of the pots and sing until your voice was hoarse.

You could stand on top of one of them and jump up and down until someone made you stop.

You could do a million things. Or nothing at all.

>n
A Stream
You run far this time, and come upon a stream where a father plays with his two daughters.

You can see a Korean man and a Korean girls here.

>lie in stream
You are now reclining in the stream. Arms outstretched.

>drink
(the stream)
You bend down, place your head in the stream, and open your mouth. The water rushes into mouth, down your throat, and fills your stomach.

A Stream (in the stream)
You run far this time, and come upon a stream where a father plays with his two daughters.

You can see a Korean man and a Korean girls here.

>talk to man
You say hello to the Korean man.

>say "boo"
Whom do you want to say that to?

>man
There is no reply.

* * *

>drink water
You bend down, place your head in the stream, and open your mouth. The water rushes into your mouth, down your throat, and fills your stomach. Bloated, you fall over with a splash. You are now reclining in the stream.

>drink eunpa
There's nothing suitable to drink here.

>drink eunpa
There's nothing suitable to drink here.

* * *

>drink water
You bend down, place your head in the stream, and open your mouth. The water rushes into your mouth, down your throat, and fills your stomach. Bloated, you fall over with a splash. You are now reclining in the stream.

>drink water
Being handily located in the stream already, you open your mouth and let the water rush in.

>drink
(the stream)
Being handily located in the stream already, you open your mouth and let the water rush in.

>taste stream
Being handily located in the stream already, you open your mouth and let the water rush in.

>kiss girl
(the Korean girls)
You're worried that they might take that the wrong way.

>n
(first leaving the stream)

Sandlot
You follow the stream, walking north, until the stream becomes a river and you can no longer touch the bottom. Then you float with your eyes closed, until the river washes you up on an asphalt shore, where two boys play baseball at dusk.

You feel your time is drawing short. You won't be able to stay here long.

>take ball
You can't see any such thing.

>x bat
A typicall baseball bat.

>take bat
Through pantomime you demonstrate to the boys that you are an exceptional baseball player. They gladly let you join in, and you play for some time.

* * *

Being There

During the course of play you will be taken to a series of locations. In each location you can do various things by typing commands into the text prompt. Try things like:

listen
examine the stripe
touch the street
dance on the sidewalk
climb the tree
taste the flower

Please press SPACE to continue.

>say "boo" to man
booya
There is no reply.

>say "boo
Whom do you want to say that to?

>man
There is no reply.

>say "boo"
Whom do you want to say that to?

* * *

>man
There is no reply.

>say "boo" to man
There is no reply.

>goodbye
You say goodbye to the Korean man.

>hello
(addressing the Korean man)
booya

>goodbye
You say goodbye to the Korean man.

>say "boo" to man
booya
There is no reply.

>goodbye
You say goodbye to the Korean man.

* * *

Being There

During the course of play you will be taken to a series of locations. In each location you can do various things by typing commands into the text prompt. Try things like:

listen
examine the stripe
touch the street
dance on the sidewalk
climb the tree
taste the flower

Please press SPACE to continue.

>say hello
(addressing the Korean girls)
The girl in the striped suit looks over at you and smiles. The other girl is too busy trying not to slip to notice your voice.

>say hello to man
You say hello to the Korean man.

>ask man about weather
booya

* * *

>say hello
(addressing the Korean girls)
The girl in the striped suit looks over at you and smiles. The other girl is too busy trying not to slip to notice your voice.

>say goodbye
Whom do you want to say goodbye to?

>girls
The girls giggle and point at you enthusiastically.

* * *

Being There

During the course of play you will be taken to a series of locations. In each location you can do various things by typing commands into the text prompt. Try things like:

listen
examine the stripe
touch the street
dance on the sidewalk
climb the tree
taste the flower

Please press SPACE to continue.

>talk to man
booya

* * *

Being There

During the course of play you will be taken to a series of locations. In each location you can do various things by typing commands into the text prompt. Try things like:

listen
examine the stripe
touch the street
dance on the sidewalk
climb the tree
taste the flower

Please press SPACE to continue.

>say hello to man
The man glances at you and smiles.

>say hello
You are already talking to the Korean man.

>say hi to girls
You say hello to the Korean girls.

>say goodbye
Whom do you want to say goodbye to?

>man
You're not talking to the Korean man.

>say goodbye
Whom do you want to say goodbye to?

* * *

>man
You're not talking to the Korean man.

>goodbye
You say goodbye to the Korean girls.

* * *

>say hello to man
The man glances at you and smiles.

>goodbye
The man smiles and nods.

* * *

Being There

During the course of play you will be taken to a series of locations. In each location you can do various things by typing commands into the text prompt. Try things like:

listen
examine the stripe
touch the street
dance on the sidewalk
climb the tree
taste the flower

Please press SPACE to continue.

>say "my name is Jordan"
Whom do you want to say that to?

>the girls
There is no reply.

* * *

Being There

During the course of play you will be taken to a series of locations. In each location you can do various things by typing commands into the text prompt. Try things like:

listen
examine the stripe
touch the street
dance on the sidewalk
climb the tree
taste the flower

Please press SPACE to continue.

>say "baby" to korean man
There is no reply.

>say "hello" to the korean man
There is no reply.

>ask korean man about his life
The man glances at you and smiles.

There is no reply.

>say hello
You are already talking to the Korean man.

>say "I love you"
Whom do you want to say that to?

>man
There is no reply.

>tell the man your name is "jordan"
There is no reply.

>tell the man about links
The man smiles and nods.

This provokes no reaction.

>say my name is jordan
Whom do you want to say that to?

>mn
You can't see any such thing.

>man
That's not a verb I recognize.

>say my name is
Whom do you want to say that to?

>man
There is no reply.

>hello to man
I only understood you as far as wanting to hello.

>say hello to man
You are already talking to the Korean man.

>goodbye
You say goodbye to the Korean man.

>hello to man
I only understood you as far as wanting to hello.

>say hello to man
You say hello to the Korean man.

* * *

Being There

During the course of play you will be taken to a series of locations. In each location you can do various things by typing commands into the text prompt. Try things like:

listen
examine the stripe
touch the street
dance on the sidewalk
climb the tree
taste the flower

Please press SPACE to continue.

>drink
What do you want to drink?

>water
You can't see any such thing.

>drink lake
You can't see any such thing.

>x lake
You can't see any such thing.

>x eunpa
You can't see any such thing.

* * *

Being There

During the course of play you will be taken to a series of locations. In each location you can do various things by typing commands into the text prompt. Try things like:

listen
examine the stripe
touch the street
dance on the sidewalk
climb the tree
taste the flower

Please press SPACE to continue.

>drink eunpa
You drink of Eunpa lake.

>drink
What do you want to drink?

>water
You drink of Eunpa lake.

* * *

Being There

During the course of play you will be taken to a series of locations. In each location you can do various things by typing commands into the text prompt. Try things like:

listen
examine the stripe
touch the street
dance on the sidewalk
climb the tree
taste the flower

Please press SPACE to continue.

>x bat
A typicall baseball bat.

>take bat
That seems to belong to the baseball players.

>x boys
You can't see any such thing.

* * *

Being There

During the course of play you will be taken to a series of locations. In each location you can do various things by typing commands into the text prompt. Try things like:

listen
examine the stripe
touch the street
dance on the sidewalk
climb the tree
taste the flower

Please press SPACE to continue.

>talk to boys
The boys turn and look at you. "Hello! Hello!" they shout excitedly.

>g
You are already talking to the baseball players.

>talk to boys
You are already talking to the baseball players.

>say hello
You are already talking to the baseball players.

>say my name is
(to the baseball players)
There is no reply.

>ask the boys about their names
"My name is Bong-cha! My name is Chang-sun!" yell the boys.

>g
The boys seem focused on their baseball playing.

>g
The boys seem focused on their baseball playing.

I beg your pardon?

>g
The boys seem focused on their baseball playing.

* * *

Being There

During the course of play you will be taken to a series of locations. In each location you can do various things by typing commands into the text prompt. Try things like:

listen
examine the stripe
touch the street
dance on the sidewalk
climb the tree
taste the flower

Please press SPACE to continue.

>leave
You can't go that way.

>leave
You can't go that way.

>s
A Group of Boys
You follow the stream, walking south, until the stream becomes a river and you can no longer touch the bottom. Then you float with your eyes closed, until the river washes you up on an asphalt shore, where two boys play baseball at dusk.

You feel your time is drawing short. You won't be able to stay here long.

* * *

>s
Sandlot
You follow the stream, walking south, until the stream becomes a river and you can no longer touch the bottom. Then you float with your eyes closed, until the river washes you up on an asphalt shore, where two boys play baseball at dusk.

You feel your time is drawing short. You won't be able to stay here long.

2

>leave
A Group of Boys
You follow the stream, walking north, until the stream becomes a river and you can no longer touch the bottom. Then you float with your eyes closed, until the river washes you up on an asphalt shore, where two boys play baseball at dusk.

You feel your time is drawing short. You won't be able to stay here long.

* * *

>s
A Group of Boys
You follow the stream, walking south, until the stream becomes a river and you can no longer touch the bottom. Then you float with your eyes closed, until the river washes you up on an asphalt shore, where two boys play baseball at dusk.

You feel your time is drawing short. You won't be able to stay here long.

I beg your pardon?

>s
Sandlot
You follow the stream, walking south, until the stream becomes a river and you can no longer touch the bottom. Then you float with your eyes closed, until the river washes you up on an asphalt shore, where two boys play baseball at dusk.

You feel your time is drawing short. You won't be able to stay here long.

2

>s
A Stream
You run far this time, and come upon a stream where a father plays with his two daughters.

* * *

>s
Napo Field
You fly south until you can fly no more. Then you land here, in a middle school soccer field.

The air is cool and crisp to the touch. Autumn has come, and the birds will be here soon, stopping in this field on their way south. Or maybe they've already been.

There are some parallel bars in the distance. You could swing from those bars, or climb that barren tree. Or yoo could just keep going south.

I beg your pardon?

>s
Maisan Mountain
After traveling south for some time you find yourself atop Maisain Mountain, looking out over the farmland of North Jeolla. There's a golf course down there that you might just be able to touch, as well some man-made lakes and Geum River, winding itself towards the Yellow Sea.

You could dance in the sky here, if you wanted. You could probably fly.

* * *

>s
You can't go that way.

>leave
Maisan Mountain
After traveling north, south, east, west for some time you find yourself atop Maisain Mountain, looking out over the farmland of North Jeolla. There's a golf course down there that you might just be able to touch, as well some man-made lakes and Geum River, winding itself towards the Yellow Sea.

You could dance in the sky here, if you wanted. You could probably fly.

* * *

>leave
You can't go that way.

>leave
Kimchi Pots
Walking north you come upon some gaint Kimchi pots.

If there was kimchi in one of those pots you could eat it... you could put it in your mouth and let the spices soak your tongue.

You could climb into one of the pots and sing until your voice was hoarse.

You could stand on top of one of them and jump up and down until someone made you stop.

You could do a million things. Or nothing at all.

* * *

>leave
You can't go that way.

>s
Sandlot
You follow the stream, walking south, until the stream becomes a river and you can no longer touch the bottom. Then you float with your eyes closed, until the river washes you up on an asphalt shore, where two boys play baseball at dusk.

You feel your time is drawing short. You won't be able to stay here long.

2

* * *

>s
Blossom Street
A street stretches in front of you. You don't know this street, but it exists. Above you, and all around you, are cherry blossoms: they fill the street gutter; they overflow onto a yellow stripe of paint; they enter your nose, and come out your ears.

You see grass to the left. To the right is a yellow stripe, a streetlight, and a fence.

You could sit here if you wanted. You could run and dance on that yellow stripe. You could lie in the street and let the cherry blossoms burry you. If you wanted.

>sit on road
You are now seated on the road. You feel a pebble beneath your buttock.

>leave
Maisan Mountain
After traveling north for some time you find yourself atop Maisain Mountain, looking out over the farmland of North Jeolla. There's a golf course down there that you might just be able to touch, as well some man-made lakes and Geum River, winding itself towards the Yellow Sea.

You could dance in the sky here, if you wanted. You could probably fly.

* * *

>leave
You can't go that way.

>north
A Pavilion
You run far this time. Past all the empty places, until you find two boys playing baseball at dusk in an empty lot.

* * *

Being There

During the course of play you will be taken to a series of locations. In each location you can do various things by typing commands into the text prompt. Try things like:

listen
examine the stripe
touch the street
dance on the sidewalk
climb the tree
taste the flower

Please press SPACE to continue.

>x chang-sun
Two boys taking part in one of Korea's favorite pastimes.

* * *

Being There

During the course of play you will be taken to a series of locations. In each location you can do various things by typing commands into the text prompt. Try things like:

listen
examine the stripe
touch the street
dance on the sidewalk
climb the tree
taste the flower

Please press SPACE to continue.

>x sky
As you peer at the sky it seems to dance.

>n
Maisan Mountain
After traveling north for some time you find yourself atop Maisain Mountain, looking out over the farmland of North Jeolla. There's a golf course down there that you might just be able to touch, as well some man-made lakes and Geum River, winding itself towards the Yellow Sea.

You could dance in the sky here, if you wanted. You could probably fly.

>x sky
The sky is half the world here.

* * *

Being There

During the course of play you will be taken to a series of locations. In each location you can do various things by typing commands into the text prompt. Try things like:

listen
examine the stripe
touch the street
dance on the sidewalk
climb the tree
taste the flower

Please press SPACE to continue.

>x ground
Which do you mean, the ground, or the road?

>road
It's an asphalt road.

* * *

Being There

During the course of play you will be taken to a series of locations. In each location you can do various things by typing commands into the text prompt. Try things like:

listen
examine the stripe
touch the street
dance on the sidewalk
climb the tree
taste the flower

Please press SPACE to continue.

>taste lamp
That's one way to get your body's daily dose of metals.

>dance in road
You are now dancing on the road. You spin and you spin, until you can't see straight.

>sit on ground
(getting off the road)

*** Run-time problem P10: Since the ground is not allowed the property "posture", it is against the rules to try to use it.

You can't take that position on the ground.

* * *

Being There

During the course of play you will be taken to a series of locations. In each location you can do various things by typing commands into the text prompt. Try things like:

listen
examine the stripe
touch the street
dance on the sidewalk
climb the tree
taste the flower

Please press SPACE to continue.

>sing on ground
*** Run-time problem P10: Since the ground is not allowed the property "posture", it is against the rules to try to use it.

You are now singing on the ground. You belt it out like a good one.

* * *

Being There

During the course of play you will be taken to a series of locations. In each location you can do various things by typing commands into the text prompt. Try things like:

listen
examine the stripe
touch the street
dance on the sidewalk
climb the tree
taste the flower

Please press SPACE to continue.

>dance in sky
You are now dancing in the sky. You spin and you spin, until you can't see straight.

>dance on ground
You are now dancing on the ground. You spin and you spin, until you can't see straight.

* * *

Being There

During the course of play you will be taken to a series of locations. In each location you can do various things by typing commands into the text prompt. Try things like:

listen
examine the stripe
touch the street
dance on the sidewalk
climb the tree
taste the flower

Please press SPACE to continue.

>dance in gutter
The gutter's a bit small for dancing.

>sit in gutter
You are now seated on the gutter. You feel a pebble beneath your buttock.

>fly in sky
You can't get into the closed sky.

>enter gutter
But you're already in the gutter.

>enter street
(getting out of the gutter)
You get onto the road.

* * *

>dance in gutter
The gutter's a bit small for dancing.

>dance on gutter
The gutter's a bit small for dancing.

>sit on gutter
You are now seated on the gutter. You feel a breeze behind you.

>dancing in gutter
That's not a verb I recognize.

* * *

>dance in gutter
The gutter's a bit small for dancing.

>fly in gutter
You can't take that position on the gutter.

>dance in gutter
You are now dancing on the gutter.

* * *

>dance in gutter
The gutter's a bit small for dancing.

>dance in gutter
You are now dancing on the gutter. You spin and you spin, until you can't see straight.

* * *

Being There

During the course of play you will be taken to a series of locations. In each location you can do various things by typing commands into the text prompt. Try things like:

listen
examine the stripe
touch the street
dance on the sidewalk
climb the tree
taste the flower

Please press SPACE to continue.

>dance on gutter
The gutter's a bit small for dancing.

>dance in gutter
You are now dancing on the gutter.

>dance on gutter
You are now dancing on the gutter. You spin and you spin, until you can't see straight.

* * *

>dance on gutter
The gutter's a bit small for dancing.

>dance on grass
You are now dancing on the grass. You spin and you spin, until you can't see straight.

>x grass
Among the most versatile of life forms. This patch is soft and green.

>smell the grass
Smells like the grassy green odor you know so well.

>smell
Smells surround you...
Paint and asphalt mixed with cherry blossoms.
The grassy green odor you know so well.
Earthworms and rubber.
Perfume.
sOmething sweet and dewy.
sOmething sweet and dewy, mixed with bark.
Fresh mountain air.
The earth.

>x air
You can't see any such thing.

>x sky
As you peer at the sky it seems to dance.

>smell sky
Smells like fresh mountain air.

* * *

Being There

During the course of play you will be taken to a series of locations. In each location you can do various things by typing commands into the text prompt. Try things like:

listen
examine the stripe
touch the street
dance on the sidewalk
climb the tree
taste the flower

Please press SPACE to continue.

>x sdfsd
You can't see any such thing.

>n
Maisan Mountain
After traveling north for some time you find yourself atop Maisain Mountain, looking out over the farmland of North Jeolla. There's a golf course down there that you might just be able to touch, as well some man-made lakes and Geum River, winding itself towards the Yellow Sea.

You could dance in the sky here, if you wanted. You could probably fly.

* * *

>n
Sandlot
You follow the stream, walking north, until the stream becomes a river and you can no longer touch the bottom. Then you float with your eyes closed, until the river washes you up on an asphalt shore, where two boys play baseball at dusk.

You feel your time is drawing short. You won't be able to stay here long.

>x sdfsd
You can't see any such thing.

>z
Time passes.

* * *

>z
Time is short: you must leave this place.

>x sdfsd
Time is short: you must leave this place.

>n
A Group of Boys
You make your way qucikly north, but a group of smiling boys jumps in front of you.

"Kimchi! My name is Bae! Hello! I love you! My name is Chin-ho!"

>x boys
A group of smiling boys; they look to be in grade school.

>talk to boys
There is no more time to spare: you must keep moving.

>n
A Pavilion
You manage to break away from the group of boys. Running now, panting, you've hardly any time left. Glancing to your right, you see a man helping a yong boy take off his shoes before entering a pavilion.

>x boy
There is no time to stop now.

>n
Leaving
You're flying now, faster than you've ever flown before... the air that streams by you feels like a thick liquid. Glancing over your shoulder, your last glimpse of Korea is a girl in red stripes, holding an umbrella.

And then she's gone.

    *** Being There. A notgame for Korea, created by Jordan Magnuson. ***

Would you like to RESTART, RESTORE a saved game, or QUIT?

* * *

Being There

During the course of play you will be taken to a series of locations. In each location you can do various things by typing commands into the text prompt. Try things like:

listen
examine the stripe
touch the street
dance on the sidewalk
climb the tree
taste the flower

Please press SPACE to continue.

When you are ready to leave a location, type "go north," or "go west." Alternately you can just type "leave."

Please press SPACE to continue.

>s
Being There
"Being There" is short, experimental work of interactive fiction about existence and Korea. It is not a game, and you don't need to be familiar with interactive fiction to play it.

During the course of play you will be taken to a series of locations. In each location you can do various things by typing commands into the text prompt. Try things like:

 listen
 touch the street
 dance on the sidewalk
 climb the tree
 taste the flower

When you are ready to leave a location, type "go north," or "go west." Alternately you can just type "leave."

Please press SPACE to continue.

Blossom Street
A street stretches in front of you. You don't know this street, but it exists. Above you, and all around you, are cherry blossoms: they fill the street gutter; they overflow onto a yellow stripe of paint; they enter your nose, and come out your ears.

You see grass to the left. To the right is a yellow stripe, a streetlight, and a fence.

You could sit here if you wanted. You could run and dance on that yellow stripe. You could lie in the street and let the cherry blossoms burry you. If you wanted.

>s
Being There
"Being There" is short, experimental work of interactive fiction about existence and Korea. It is not a game, and you don't need to be familiar with interactive fiction to play it.

During the course of play you will be taken to a series of locations. In each location you can do various things by typing commands into the text prompt. Try things like:

 listen
 touch the street
 dance on the sidewalk
 climb the tree
 taste the flower

When you are ready to leave a location, type "go north," or "go west." Alternately you can just type "leave."

Please press SPACE to continue.

* * *

Blossom Street
A street stretches in front of you. You don't know this street, but it exists. Above you, and all around you, are cherry blossoms: they fill the street gutter; they overflow onto a yellow stripe of paint; they enter your nose, and come out your ears.

You see grass to the left. To the right is a yellow stripe, a streetlight, and a fence.

You could sit here if you wanted. You could run and dance on that yellow stripe. You could lie in the street and let the cherry blossoms burry you. If you wanted.

>s
Being There
"Being There" is short, experimental work of interactive fiction about existence and Korea. It is not a game, and you don't need to be familiar with interactive fiction to play it.

During the course of play you will be taken to a series of locations. In each location you can do various things by typing commands into the text prompt. Try things like:

 listen
 touch the street
 dance on the sidewalk
 climb the tree
 taste the flower

When you are ready to leave a location, type "go north," or "go west." Alternately you can just type "leave."

Blossom Street
A street stretches in front of you. You don't know this street, but it exists. Above you, and all around you, are cherry blossoms: they fill the street gutter; they overflow onto a yellow stripe of paint; they enter your nose, and come out your ears.

You see grass to the left. To the right is a yellow stripe, a streetlight, and a fence.

You could sit here if you wanted. You could run and dance on that yellow stripe. You could lie in the street and let the cherry blossoms burry you. If you wanted.

>leave
Maisan Mountain
After traveling west for some time you find yourself atop Maisain Mountain, looking out over the farmland of North Jeolla. There's a golf course down there that you might just be able to touch, as well some man-made lakes and Geum River, winding itself towards the Yellow Sea.

You could dance in the sky here, if you wanted. You could probably fly.

>s
Blossom Street
A street stretches in front of you. You don't know this street, but it exists. Above you, and all around you, are cherry blossoms: they fill the street gutter; they overflow onto a yellow stripe of paint; they enter your nose, and come out your ears.

You see grass to the left. To the right is a yellow stripe, a streetlight, and a fence.

You could sit here if you wanted. You could run and dance on that yellow stripe. You could lie in the street and let the cherry blossoms burry you. If you wanted.

>exit
But you aren't in anything at the moment.

>go north
Maisan Mountain
After traveling north for some time you find yourself atop Maisain Mountain, looking out over the farmland of North Jeolla. There's a golf course down there that you might just be able to touch, as well some man-made lakes and Geum River, winding itself towards the Yellow Sea.

You could dance in the sky here, if you wanted. You could probably fly.

>s
Blossom Street
A street stretches in front of you. You don't know this street, but it exists. Above you, and all around you, are cherry blossoms: they fill the street gutter; they overflow onto a yellow stripe of paint; they enter your nose, and come out your ears.

You see grass to the left. To the right is a yellow stripe, a streetlight, and a fence.

You could sit here if you wanted. You could run and dance on that yellow stripe. You could lie in the street and let the cherry blossoms burry you. If you wanted.

>s
Being There
"Being There" is short, experimental work of interactive fiction about existence and Korea. It is not a game, and you don't need to be familiar with interactive fiction to play it.

During the course of play you will be taken to a series of locations. In each location you can do various things by typing commands into the text prompt. Try things like:

 listen
 touch the street
 dance on the sidewalk
 climb the tree
 taste the flower

When you are ready to leave a location, type "go north," or "go west." Alternately you can just type "leave."

Please press SPACE to continue.

* * *

>n
Maisan Mountain
After traveling north for some time you find yourself atop Maisain Mountain, looking out over the farmland of North Jeolla. There's a golf course down there that you might just be able to touch, as well some man-made lakes and Geum River, winding itself towards the Yellow Sea.

You could dance in the sky here, if you wanted. You could probably fly.

>s
Blossom Street
A street stretches in front of you. You don't know this street, but it exists. Above you, and all around you, are cherry blossoms: they fill the street gutter; they overflow onto a yellow stripe of paint; they enter your nose, and come out your ears.

You see grass to the left. To the right is a yellow stripe, a streetlight, and a fence.

You could sit here if you wanted. You could run and dance on that yellow stripe. You could lie in the street and let the cherry blossoms burry you. If you wanted.

>s
Being There
"Being There" is short, experimental work of interactive fiction about existence and Korea. It is not a game, and you don't need to be familiar with interactive fiction to play it.

During the course of play you will be taken to a series of locations. In each location you can do various things by typing commands into the text prompt. Try things like:

 listen
 touch the street
 dance on the sidewalk
 climb the tree
 taste the flower

When you are ready to leave a location, type "go north," or "go west." Alternately you can just type "leave."

>d
Blossom Street
A street stretches in front of you. You don't know this street, but it exists. Above you, and all around you, are cherry blossoms: they fill the street gutter; they overflow onto a yellow stripe of paint; they enter your nose, and come out your ears.

You see grass to the left. To the right is a yellow stripe, a streetlight, and a fence.

You could sit here if you wanted. You could run and dance on that yellow stripe. You could lie in the street and let the cherry blossoms burry you. If you wanted.

>s
Being There
"Being There" is short, experimental work of interactive fiction about existence and Korea. It is not a game, and you don't need to be familiar with interactive fiction to play it.

During the course of play you will be taken to a series of locations. In each location you can do various things by typing commands into the text prompt. Try things like:

 listen
 touch the street
 dance on the sidewalk
 climb the tree
 taste the flower

When you are ready to leave a location, type "go north," or "go west." Alternately you can just type "leave."

* * *

>n
A Pavilion
You manage to break away from the group of boys. Running now, panting, you've hardly any time left. Glancing to your right, you see a man helping a yong boy take off his shoes before entering a pavilion.

>n
Leaving
You're flying now, faster than you've ever flown before... the air that streams by you feels like a thick liquid. Glancing over your shoulder, your last glimpse of Korea is a girl in red stripes, holding an umbrella.

And then she's gone.

Please press SPACE to continue.

>g
Being There. A notgame for Korea, created by Jordan Magnuson.

Being There. A notgame for Korea, created by Jordan Magnuson.

* * *

>n
A Group of Boys
You make your way qucikly north, but a group of smiling boys jumps in front of you.

"Kimchi! My name is Bae! Hello! I love you! My name is Chin-ho!"

>s
A Pavilion
You manage to break away from the group of boys. Running now, panting, you've hardly any time left. Glancing to your right, you see a man helping a young boy take off his shoes before entering a pavilion.

* * *

>n
Kimchi Pots
Walking north you come upon some gaint Kimchi pots.

If there was kimchi in one of those pots you could eat it... you could put it in your mouth and let the spices soak your tongue.

You could climb into one of the pots and sing until your voice was hoarse.

You could stand on top of one of them and jump up and down until someone made you stop.

You could do a million things. Or nothing at all.

>eat kimchi
You need to open the pot firstYou can't see any such thing.

* * *

>n
Kimchi Pots
Walking north you come upon some gaint Kimchi pots.

If there was kimchi in one of those pots you could eat it... you could put it in your mouth and let the spices soak your tongue.

You could climb into one of the pots and sing until your voice was hoarse.

You could stand on top of one of them and jump up and down until someone made you stop.

You could do a million things. Or nothing at all.

>eat
You'll need to open a pot first.

>open pot
You open a kimchi pot, revealing more kimchi than you know what to do with.

* * *

>kimchi
You take a bite of the kimchi. Spicy and delicious.

>eat more
A lot of words like prepositions and adverbs are not necessary in interactive fiction.

(retrying as if you'd typed "eat .")
What do you want to eat?

>kimchi
You take another bite.

>what's going on?
Try typing LOOK for a description of your surroundings. If you saw a sword, you might try EXAMINE SWORD to get more details. Any compass directions indicate exits which you can use by typing NORTH or whatever. Type INVENTORY to see a list of what you're carrying. You can also TAKE or DROP some things, OPEN or CLOSE others, and more.

>go back
A Stream
You run far this time, and come upon a stream where a father plays with his two daughters.

>go south carefully
A lot of words like prepositions and adverbs are not necessary in interactive fiction.

(retrying as if you'd typed "go south .")

Sandlot
You follow the stream, walking south, until the stream becomes a river and you can no longer touch the bottom. Then you float with your eyes closed, until the river washes you up on an asphalt shore, where two boys play baseball at dusk.

You feel your time is drawing short. You won't be able to stay here long.

>inspect bat
That's not a verb I recognize.

>examine bat carefully
A lot of words like prepositions and adverbs are not necessary in interactive fiction.

(retrying as if you'd typed "examine bat .")
A typicall baseball bat.

>s
A Group of Boys
You make your way qucikly south, but a group of smiling boys jumps in front of you.

"Kimchi! My name is Bae! Hello! I love you! My name is Chin-ho!"

>hellop
That's not a verb I recognize.

>hello
(addressing the boys)
"Annyeonghaseyo!" yell the boys in unison. One of them is jumping uncontrollably.

>n
There is no more time to spare: you must keep moving.

A Pavilion
You manage to break away from the group of boys. Running now, panting, you've hardly any time left. Glancing to your right, you see a man helping a yong boy take off his shoes before entering a pavilion.

>s
Leaving
You're flying now, faster than you've ever flown before... the air that streams by you feels like a thick liquid. Glancing over your shoulder, your last glimpse of Korea is a girl in red stripes, holding an umbrella.

And then she's gone.

>n
Being There. A notgame for Korea, created by Jordan Magnuson.

* * *

>n
Kimchi Pots
Walking north you come upon some gaint Kimchi pots.

If there was kimchi in one of those pots you could eat it... you could put it in your mouth and let the spices soak your tongue.

You could climb into one of the pots and sing until your voice was hoarse.

You could stand on top of one of them and jump up and down until someone made you stop.

You could do a million things. Or nothing at all.

>sit in kimchi
You can't see any such thing.

>sit in pot
You are now sitting on one of the closed kimchi pots. You feel the power of kimchi beneath you.

>eat kimchi
You'll need to open a pot first.

>sing
You are now singing. You belt it out like a good one.

>sing in pot
You are now singing on a closed kimchi pot.

>open pot
You open a kimchi pot, revealing more kimchi than you know what to do with.

>sit on pot
You are now sitting on one of the closed kimchi pots. You feel the power of kimchi beneath you.

>sit in pot
You are now sitting in an open kimchi pot; the strong spicy odor surrounds you, and the cabbage is soft beneath you.

>n
(first leaving the closed kimchi pot)

A Stream
You run far this time, and come upon a stream where a father plays with his two daughters.

>go swimming
You can't see any such thing.

>swim
(in the stream)
Some might say the water's a bit shallow for swimming, but that doesn't stop you from diving in head first and splashing about like a maniac.

>bathe
You have a nice bathe.

>s
Sandlot
You follow the stream, walking south, until the stream becomes a river and you can no longer touch the bottom. Then you float with your eyes closed, until the river washes you up on an asphalt shore, where two boys play baseball at dusk.

You feel your time is drawing short. You won't be able to stay here long.

>s
A Group of Boys
You make your way qucikly south, but a group of smiling boys jumps in front of you.

"Kimchi! My name is Bae! Hello! I love you! My name is Chin-ho!"

>swim
What do you want to swim in?

>s
You must name something more substantial.

>s
A Pavilion
You manage to break away from the group of boys. Running now, panting, you've hardly any time left. Glancing to your right, you see a man helping a yong boy take off his shoes before entering a pavilion.

>s
Leaving
You're flying now, faster than you've ever flown before... the air that streams by you feels like a thick liquid. Glancing over your shoulder, your last glimpse of Korea is a girl in red stripes, holding an umbrella.

And then she's gone.

* * *

>n
Temple Spring
You wander north for hours, searching for you don't know what. And then you find it: a fresh spring at the temple of the nirvana fish, spouting clean, cold water from a bamboo shoot.

The water flows onto a stone platform, then over the edge, and away.

You can see a cup here.

>play baseball
Through pantomime you demonstrate to the boys that you are an exceptional baseball player. They gladly let you join in, and you play for some time.

* * *

>n
Napo Field
You fly north until you can fly no more. Then you land here, in a middle school soccer field.

The air is cool and crisp to the touch. Autumn has come, and the birds will be here soon, stopping in this field on their way south. Or maybe they've already been.

There are some parallel bars in the distance. You could swing from those bars, or climb that barren tree. Or yoo could just keep going north.

>play soccer
You play soccer with an invisible ball.

>play
You play soccer with an invisible ball.

>stop
You stop what you're doing.

* * *

>n
Temple Spring
You wander north for hours, searching for you don't know what. And then you find it: a fresh spring at the temple of the nirvana fish, spouting clean, cold water from a bamboo shoot.

The water flows onto a stone platform, then over the edge, and away.

You can see a cup here.

* * *

>n
Maisan Mountain
After traveling north for some time you find yourself atop Maisain Mountain, looking out over the farmland of North Jeolla. There's a golf course down there that you might just be able to touch, as well some man-made lakes and Geum River, winding itself towards the Yellow Sea.

You could dance in the sky here, if you wanted. You could probably fly.

>swim
What do you want to swim in?

* * *

Blossom Street
A street stretches in front of you. You don't know this street, but it exists. Above you, and all around you, are cherry blossoms: they fill the street gutter; they overflow onto a yellow stripe of paint; they enter your nose, and come out your ears.

You see grass to the left. To the right is a yellow stripe, a streetlight, and a fence.

You could sit here if you wanted. You could run and dance on that yellow stripe. You could lie in the street and let the cherry blossoms bury you. If you wanted.

>s
Being There

During the course of play you will be taken to a series of locations. In each location you can do various things by typing commands into the text prompt. Try things like:

listen
examine the stripe
touch the street
dance on the sidewalk
climb the tree
taste the flower

Please press SPACE to continue.

When you are ready to leave a location, type "go north," or "go west." Alternately you can just type "leave."

Please press SPACE to continue.

* * *

Blossom Street
A street stretches in front of you. You don't know this street, but it exists. Above you, and all around you, are cherry blossoms: they fill the street gutter; they overflow onto a yellow stripe of paint; they enter your nose, and come out your ears.

You see grass to the left. To the right is a yellow stripe, a streetlight, and a fence.

You could sit here if you wanted. You could run and dance on that yellow stripe. You could lie in the street and let the cherry blossoms bury you. If you wanted.

>sit on stripe
You can't see any such thing.

* * *

Blossom Street
A street stretches in front of you. You don't know this street, but it exists. Above you, and all around you, are cherry blossoms: they fill the street gutter; they overflow onto a yellow stripe of paint; they enter your nose, and come out your ears.

You see grass to the left. To the right is a yellow stripe, a streetlight, and a fence.

You could sit here if you wanted. You could run and dance on that yellow stripe. You could lie in the street and let the cherry blossoms bury you. If you wanted.

>north
north

Maisan Mountain
After traveling north for some time you find yourself atop Maisain Mountain, looking out over the farmland of North Jeolla. There's a golf course down there that you might just be able to touch, as well some man-made lakes and Geum River, winding itself towards the Yellow Sea.

You could dance in the sky here, if you wanted. You could probably fly.

* * *

Blossom Street
A street stretches in front of you. You don't know this street, but it exists. Above you, and all around you, are cherry blossoms: they fill the street gutter; they overflow onto a yellow stripe of paint; they enter your nose, and come out your ears.

You see grass to the left. To the right is a yellow stripe, a streetlight, and a fence.

You could sit here if you wanted. You could run and dance on that yellow stripe. You could lie in the street and let the cherry blossoms bury you. If you wanted.

>smell
Smells surround you...
...paint and asphalt mixed with cherry blossoms.
...the grassy green odor you know so well from all the time you've spent lying in it.
...earthworms and rubber.
...perfume.
...something sweet and dewy.
...something sweet and dewy, mixed with bark.

>x branches
The indigenous cherry blossom trees bloom once a year in Korea, in the spring, and only for a week.

>n
Maisan Mountain
After traveling north for some time you find yourself atop Maisain Mountain, looking out over the farmland of North Jeolla. There's a golf course down there that you might just be able to touch, as well some man-made lakes and Geum River, winding itself towards the Yellow Sea.

You could dance in the sky here, if you wanted. You could probably fly.

>fly
You are now flying. You feel millions Nitrogen and Oxygen particles hitting your skin.

>dance
You are now dancing. You spin and you spin, until you can't see straight.

>fly in sky
You are now flying on the sky. Are you a bird?

>fly on sky
You are now flying on the sky. Are you a plane?

>n
(first leaving the sky)

Napo Field
You fly north until you can fly no more. Then you land here, in a middle school soccer field.

The air is cool and crisp to the touch. Autumn has come, and the birds will be here soon, stopping in this field on their way south. Or maybe they've already been.

There are some parallel bars in the distance. You could swing from those bars, or climb that barren tree. Or yoo could just keep going north.

>fly in sky
You are now flying in the sky.

>fly on sky
You are now flying in the sky. Like the fastest things on earth.

>s
(first leaving the sky)

Maisan Mountain
After traveling south for some time you find yourself atop Maisain Mountain, looking out over the farmland of North Jeolla. There's a golf course down there that you might just be able to touch, as well some man-made lakes and Geum River, winding itself towards the Yellow Sea.

You could dance in the sky here, if you wanted. You could probably fly.

>fly in sky
You are now flying on the sky. Slowly, lazily, just for fun.

* * *

Blossom Street
A street stretches in front of you. You don't know this street, but it exists. Above you, and all around you, are cherry blossoms: they fill the street gutter; they overflow onto a yellow stripe of paint; they enter your nose, and come out your ears.

You see grass to the left. To the right is a yellow stripe, a streetlight, and a fence.

You could sit here if you wanted. You could run and dance on that yellow stripe. You could lie in the street and let the cherry blossoms bury you. If you wanted.

>n
Maisan Mountain
After traveling north for some time you find yourself atop Maisain Mountain, looking out over the farmland of North Jeolla. There's a golf course down there that you might just be able to touch, as well some man-made lakes and Geum River, winding itself towards the Yellow Sea.

You could dance in the sky here, if you wanted. You could probably fly.

>fly in sky
A lot of words like prepositions and adverbs are not necessary in interactive fiction.

(retrying as if you'd typed " in sky.")
I only understood you as far as wanting to in.

>fly in maisan-sky
You are now flying on the maisan-sky.

>g
You are now flying on the maisan-sky. You feel a breeze behind you.

>g
You are now flying on the maisan-sky. You feel millions Nitrogen and Oxygen particles hitting your skin.

>g
You are now flying on the maisan-sky. Like a bird.

>g
You are now flying on the maisan-sky. Like a plane.

>g
You are now flying on the maisan-sky. Like the fastest things on earth.

>g
You are now flying on the maisan-sky. Slowly, lazily, just for fun.

>g
You are now flying on the maisan-sky. You go high, and then glide slowly towards the earth.

>g
You are now flying on the maisan-sky. You hit a hot air patch and shoot upwards geyser style.

>g
You are now flying on the maisan-sky. You feel millions Nitrogen and Oxygen particles hitting your skin.

>showme maisan-sky
maisan-sky - open container
    yourself - person
        your head (part of yourself) - head
        your nose (part of yourself) - nose
        your eyes (part of yourself) - eyes
        your eye (part of yourself) - eye
        your ears (part of yourself) - ears
        your ear (part of yourself) - ear
        your chin (part of yourself) - chin
        your hair (part of yourself) - hair
        your face (part of yourself) - face
        your hands (part of yourself) - hands
        your hand (part of yourself) - hand
        your fingers (part of yourself) - fingers
        your finger (part of yourself) - finger
        your legs (part of yourself) - legs
        your leg (part of yourself) - leg
        your feet (part of yourself) - feet
        your foot (part of yourself) - foot
        your knees (part of yourself) - knees
        your knee (part of yourself) - knee
        your Toes (part of yourself) - Toes
        your toe (part of yourself) - toe
location: in Maisan Mountain
unlit; inedible; fixed in place; scenery; singular-named; improper-named; neuter; ordinarily enumerated; seen; unfamiliar; unswingable; not-one-of-many; not drinkable; weak_smelling; soft_sounding
description: As you peer at the maisan-sky it seems to dance.
printed name: maisan-sky
printed plural name: containers
feeling: It feels like your thoughts in the morning.
flavor: You open your mouth and breathe in deep. The sky fills your lungs.
odor: fresh mountain air
sound: birds and the wind in the trees
enterable; opaque; open; unopenable; unlocked
carrying capacity: 100
known-key: no-key
posture: flying

>showme sky
sky - backdrop
location: out of play
unlit; inedible; fixed in place; scenery; singular-named; improper-named; neuter; ordinarily enumerated; unseen; unfamiliar; unswingable; not-one-of-many; not drinkable; weak_smelling; soft_sounding
description: As you peer at the sky it seems to dance.
printed name: sky
printed plural name: backdrops
feeling: It feels like your dreams.
flavor: You open your mouth and breathe in deep. The sky fills your lungs.
odor: fresh life
sound: birds and the wind in the trees
enterable; open; container
posture: flying

>showme maisan-sky
maisan-sky - open container
    yourself - person
        your head (part of yourself) - head
        your nose (part of yourself) - nose
        your eyes (part of yourself) - eyes
        your eye (part of yourself) - eye
        your ears (part of yourself) - ears
        your ear (part of yourself) - ear
        your chin (part of yourself) - chin
        your hair (part of yourself) - hair
        your face (part of yourself) - face
        your hands (part of yourself) - hands
        your hand (part of yourself) - hand
        your fingers (part of yourself) - fingers
        your finger (part of yourself) - finger
        your legs (part of yourself) - legs
        your leg (part of yourself) - leg
        your feet (part of yourself) - feet
        your foot (part of yourself) - foot
        your knees (part of yourself) - knees
        your knee (part of yourself) - knee
        your Toes (part of yourself) - Toes
        your toe (part of yourself) - toe
location: in Maisan Mountain
unlit; inedible; fixed in place; scenery; singular-named; improper-named; neuter; ordinarily enumerated; seen; unfamiliar; unswingable; not-one-of-many; not drinkable; weak_smelling; soft_sounding
description: As you peer at the maisan-sky it seems to dance.
printed name: maisan-sky
printed plural name: containers
feeling: It feels like your thoughts in the morning.
flavor: You open your mouth and breathe in deep. The sky fills your lungs.
odor: fresh mountain air
sound: birds and the wind in the trees
enterable; opaque; open; unopenable; unlocked
carrying capacity: 100
known-key: no-key
posture: flying

>fly in maisan-sky
You are now flying on the maisan-sky. Like a bird.

>s
(first leaving the maisan-sky)

Blossom Street
A street stretches in front of you. You don't know this street, but it exists. Above you, and all around you, are cherry blossoms: they fill the street gutter; they overflow onto a yellow stripe of paint; they enter your nose, and come out your ears.

You see grass to the left. To the right is a yellow stripe, a streetlight, and a fence.

You could sit here if you wanted. You could run and dance on that yellow stripe. You could lie in the street and let the cherry blossoms burry you. If you wanted.

>fly in the sky
You are now flying in the sky. Like a plane.

>fly in the air
You are now flying in the sky. Like the fastest things on earth.

>n
(first leaving the sky)

Maisan Mountain
After traveling north for some time you find yourself atop Maisain Mountain, looking out over the farmland of North Jeolla. There's a golf course down there that you might just be able to touch, as well some man-made lakes and Geum River, winding itself towards the Yellow Sea.

You could dance in the sky here, if you wanted. You could probably fly.

>fly in maisan-sky
You are now flying on the maisan-sky. Life is good.

* * *

>n
Temple Spring
You wander north for hours, searching for you don't know what. And then you find it: a fresh spring at the temple of the nirvana fish, spouting clean, cold water from a bamboo shoot.

The water flows onto a stone platform, then over the edge, and away.

You can see a cup here.

>taste boy
You can't see any such thing.

>n
Kimchi Pots
Walking north you come upon some gaint Kimchi pots.

If there was kimchi in one of those pots you could eat it... you could put it in your mouth and let the spices soak your tongue.

You could climb into one of the pots and sing until your voice was hoarse.

You could stand on top of one of them and jump up and down until someone made you stop.

You could do a million things. Or nothing at all.

* * *

>n
A Stream
You run far this time, and come upon a stream where a father plays with his two daughters.

>taste man
They probably wouldn't appreciate that.

>smell man
They probably wouldn't appreciate that.

>touch man
They probably wouldn't appreciate that.

>listen to man
Silence.

* * *

>n
Maisan Mountain
After traveling north for some time you find yourself atop Maisain Mountain, looking out over the farmland of North Jeolla. There's a golf course down there that you might just be able to touch, as well some man-made lakes and Geum River, winding itself towards the Yellow Sea.

You could dance in the sky here, if you wanted. You could probably fly.

>play
Why not? You grab a stick and play a round of golf, using it as a club.

>n
Napo Field
You fly north until you can fly no more. Then you land here, in a middle school soccer field.

The air is cool and crisp to the touch. Autumn has come, and the birds will be here soon, stopping in this field on their way south. Or maybe they've already been.

There are some parallel bars in the distance. You could swing from those bars, or climb that barren tree. Or you could just keep going north.

>play
You play soccer with an invisible ball... you score!

>n
Temple Spring
You wander north for hours, searching for you don't know what. And then you find it: A fresh spring at the temple of the nirvana fish, spouting clean, cold water from a bamboo chute.

The water flows onto a stone platform, then over the edge, and away.

>play
Please be more specific.

>play soccer
Please be more specific.

>n
Kimchi Pots
Walking north you come upon some gaint Kimchi pots.

If there was kimchi in one of those pots you could eat it... you could put it in your mouth and let the spices soak your tongue.

You could climb into one of the pots and sing until your voice was hoarse.

You could stand on top of one of them and jump up and down until someone made you stop.

You could do a million things. Or nothing at all.

* * *

>n
A Stream
You run far this time, and come upon a stream where a father plays with his two daughters.

>play
Please be more specific.

>n
Sandlot
You follow the stream, walking north, until the stream becomes a river and you can no longer touch the bottom. Then you float with your eyes closed, until the river washes you up on an asphalt shore, where two boys play baseball at dusk.

You feel your time is drawing short. You won't be able to stay here long.

* * *

Blossom Street
A street stretches in front of you. You don't know this street, but it exists. Above you, and all around you, are cherry blossoms: they fill the street gutter; they overflow onto a yellow stripe of paint; they enter your nose, and come out your ears.

You see grass to the left. To the right is a yellow stripe, a streetlight, and a fence.

You could sit here if you wanted. You could run and dance on that yellow stripe. You could lie in the street and let the cherry blossoms bury you. If you wanted.

>w
You can't go that way.

>e
Napo Field
You fly east until you can fly no more. Then you land here, in a middle school soccer field.

The air is cool and crisp to the touch. Autumn has come, and the birds will be here soon, stopping in this field on their way south. Or maybe they've already been.

There are some parallel bars in the distance. You could swing from those bars, or climb that barren tree. Or yoo could just keep going east.

* * *

>w
You can't go that way.

>go up
Maisan Mountain
After traveling up for some time you find yourself atop Maisain Mountain, looking out over the farmland of North Jeolla. There's a golf course down there that you might just be able to touch, as well some man-made lakes and Geum River, winding itself towards the Yellow Sea.

You could dance in the sky here, if you wanted. You could probably fly.

* * *

>n
Maisan Mountain
After traveling north for some time you find yourself atop Maisain Mountain, looking out over the farmland of North Jeolla. There's a golf course down there that you might just be able to touch, as well as some man-made lakes and Geum River, winding itself towards the Yellow Sea.

You could dance in the sky here, if you wanted. You could probably fly.

>w
Napo Field
You fly west until you can fly no more. Then you land here, in a middle school soccer field.

The air is cool and crisp to the touch. Autumn has come, and the birds will be here soon, stopping in this field on their way south. Or maybe they've already been.

There are some parallel bars in the distance. You could swing from those bars, or climb that barren tree. Or yoo could just keep going west.

>e
Temple Spring
You wander east for hours, searching for you don't know what. And then you find it: a fresh spring at the temple of the nirvana fish, spouting clean, cold water from a bamboo shoot.

The water flows onto a stone platform, then over the edge, and away.

You can see a cup here.

>n
Kimchi Pots
Walking north you come upon some gaint Kimchi pots.

If there was kimchi in one of those pots you could eat it... you could put it in your mouth and let the spices soak your tongue.

You could climb into one of the pots and sing until your voice was hoarse.

You could stand on top of one of them and jump up and down until someone made you stop.

You could do a million things. Or nothing at all.

>get in pot
You get into the kimchi pot.

In the kimchi pot you can see a small mountain of kimchi.

It is now pitch dark in here!

>climb in pot
I only understood the first part of that-- trying anyway.

(retrying as if you'd typed "climb in.")
You must name something more substantial.

>get into pot
But you're already in the kimchi pot.

>stand on pot
The kimchi pot isn't open.

>stand up on pot
I only understood you as far as wanting to stand up.

>sit on pot
You are now sitting on one of the closed kimchi pots. You feel the power of kimchi beneath you.

>stand on pot
The kimchi pot isn't open.

>stand on supporter-pot
You can't see any such thing.

>stand on supporter-pot
You can't see any such thing.

>sit on pot
You are now sitting on one of the closed kimchi pots. You feel the power of kimchi beneath you.

* * *

>stand on pot
The kimchi pot isn't open.

>sing on pot
The kimchi pot isn't open.

>sit on pot
You are now sitting on one of the closed kimchi pots. You feel the power of kimchi beneath you.

>dance on pot
The kimchi pot isn't open.

* * *

>n
Kimchi Pots
Walking north you come upon some gaint Kimchi pots.

If there was kimchi in one of those pots you could eat it... you could put it in your mouth and let the spices soak your tongue.

You could climb into one of the pots and sing until your voice was hoarse.

You could stand on top of one of them and jump up and down until someone made you stop.

You could do a million things. Or nothing at all.

>stand on pot
You are now standing on a closed kimchi pot. You are more like a spaghetti noodle now.

>get down
You must name something more substantial.

>get off pot
But you aren't on the kimchi pot at the moment.

>get on pot
You'll need to open one of the pots first.

>s
(first leaving the closed kimchi pot)

A Stream
You run far this time, and come upon a stream where a father plays with his two daughters.

>exit
But you aren't in anything at the moment.

>s
Sandlot
You follow the stream, walking south, until the stream becomes a river and you can no longer touch the bottom. Then you float with your eyes closed, until the river washes you up on an asphalt shore, where two boys play baseball at dusk.

You feel your time is drawing short. You won't be able to stay here long.

* * *

>stand on pot
You are now standing on a closed kimchi pot. You are more like a spaghetti noodle now.

>jump
You jump up and down like a maniac on the ceramic lid of the kimchi pot. You better hope it doesn't break under you!

>l
Kimchi Pots (on the closed kimchi pot)
If there was kimchi in one of those pots you could eat it... you could put it in your mouth and let the spices soak your tongue.

You could climb into one of the pots and sing until your voice was hoarse.

You could stand on top of one of them and jump up and down until someone made you stop.

You could do a million things. Or nothing at all.

>jump
You jump up and down like a maniac on the ceramic lid of the kimchi pot. You better hope it doesn't break under you!

>jump
The ceramic lid has had all the abuse it can take. It breaks. You land in a mountain of kimchi.

>jump
The cabbage protests by belching and squeaking under your feet.

>jump
The cabbage protests by belching and squeaking under your feet.

>sing
You are now singing in a kimchi pot.

>get out
You get out of the kimchi pot.

Kimchi Pots
If there was kimchi in one of those pots you could eat it... you could put it in your mouth and let the spices soak your tongue.

You could climb into one of the pots and sing until your voice was hoarse.

You could stand on top of one of them and jump up and down until someone made you stop.

You could do a million things. Or nothing at all.

>sing on pot
You are now singing on a closed kimchi pot. Tiny drums in your ears vibrate in time.

>jump
You better not jump on any more of the pots, now that you've broken one.

>dance
You are now dancing on a closed kimchi pot. Twirling ballet style.

>l
Kimchi Pots (on the closed kimchi pot)
If there was kimchi in one of those pots you could eat it... you could put it in your mouth and let the spices soak your tongue.

You could climb into one of the pots and sing until your voice was hoarse.

You could stand on top of one of them and jump up and down until someone made you stop.

You could do a million things. Or nothing at all.

>sing on pot
You are now singing on a closed kimchi pot.

>get in pot
(getting off the closed kimchi pot)
You get into the kimchi pot.

In the kimchi pot you can see a small mountain of kimchi.

>lie down
You are now reclining in a kimchi pot. The ether shifts around you.

>l
Kimchi Pots (in the kimchi pot)
If there was kimchi in one of those pots you could eat it... you could put it in your mouth and let the spices soak your tongue.

You could climb into one of the pots and sing until your voice was hoarse.

You could stand on top of one of them and jump up and down until someone made you stop.

You could do a million things. Or nothing at all.

In the kimchi pot you can see a small mountain of kimchi.

>get out
You get out of the kimchi pot.

Kimchi Pots
If there was kimchi in one of those pots you could eat it... you could put it in your mouth and let the spices soak your tongue.

You could climb into one of the pots and sing until your voice was hoarse.

You could stand on top of one of them and jump up and down until someone made you stop.

You could do a million things. Or nothing at all.

>stand on pot
You are now standing on a closed kimchi pot. It feels firm beneath your feet.

>lie down
You are now reclining on a closed kimchi pot. You rest your head on the earth and close your eyes.

* * *

>stand on pot
You are now standing on a closed kimchi pot. You are more like a spaghetti noodle now.

>sit down
You are now sitting on one of the closed kimchi pots. You feel the power of kimchi beneath you.

>sit
You are now sitting on one of the closed kimchi pots. You feel the power of kimchi beneath you.

You continue to sit. The world looks different.

* * *

>sit down
You are now sitting on one of the closed kimchi pots. You feel the power of kimchi beneath you.

>sit
You are now sitting on one of the closed kimchi pots. You feel the power of kimchi beneath you.

You continue to sit. The earth spins slowly.

>sit
You are now sitting on one of the closed kimchi pots. You feel the power of kimchi beneath you.

You continue to sit. You think of all the places you've never been.

* * *

>stand on pot
You are now standing on a closed kimchi pot. You are more like a spaghetti noodle now.

>dance
You are now dancing on a closed kimchi pot. This would probably be called a sword dance, if you had a sword.

>jump
You jump up and down like a maniac on the ceramic lid of the kimchi pot. You better hope it doesn't break under you!

>jump
You jump up and down like a maniac on the ceramic lid of the kimchi pot. You better hope it doesn't break under you!

* * *

>jump
The ceramic lid has had all the abuse it can take. It breaks. You land in a mountain of kimchi.

>dance
Some might say the pots are a bit small for dancing in, but you wiggle around as best you can.

>dance
Some might say the pots are a bit small for dancing in, but you wiggle around as best you can.

>stand
You are now standing in a kimchi pot.

>dance
Some might say the pots are a bit small for dancing in, but you wiggle around as best you can.

>stand
You are now standing in a kimchi pot. It seems to move under your feet. Maybe it's just the earth spinning.

* * *

>n
Kimchi Pots
Walking north you come upon some gaint Kimchi pots.

If there was kimchi in one of those pots you could eat it... you could put it in your mouth and let the spices soak your tongue.

You could climb into one of the pots and sing until your voice was hoarse.

You could stand on top of one of them and jump up and down until someone made you stop.

You could do a million things. Or nothing at all.

>enter pot
You'll need to open one of the pots first.

>get in pot
You'll need to open one of the pots first.

>get on pot
You'll need to open one of the pots first.

>stand on pot
You are now standing on a closed kimchi pot. You feel a breeze behind you.

>open pot
You open a kimchi pot, revealing more kimchi than you know what to do with.

>stand in pot
You are now standing in an open kimchi pot; the strong spicy odor surrounds you, and the cabbage is soft beneath your bare feet.

>sit in pot
You are now sitting in an open kimchi pot; the strong spicy odor surrounds you, and the cabbage is soft beneath you.

>stand in pot
You are now standing in an open kimchi pot; the strong spicy odor surrounds you, and the cabbage is soft beneath your bare feet.

>stan din pot
That's not a verb I recognize.

>stand in pot
You are now standing in an open kimchi pot; the strong spicy odor surrounds you, and the cabbage is soft beneath your bare feet.

>stand in pot
You are now standing in an open kimchi pot; the strong spicy odor surrounds you, and the cabbage is soft beneath your bare feet.

>dance in pot
Some might say the pots are a bit small for dancing in, but you wiggle around as best you can.

>dance on  pot
You are now dancing on a closed kimchi pot. You spin and you spin, until you can't see straight.

>sing in pot
You are now singing in an open kimchi pot. The cabbage resonates around you.

>s
(first leaving the closed kimchi pot)

A Stream
You run far this time, and come upon a stream where a father plays with his two daughters.

>swim in stream
Some might say the water's a bit shallow for swimming, but that doesn't stop you from diving in head first and splashing about like a maniac.

>n
Sandlot
You follow the stream, walking north, until the stream becomes a river and you can no longer touch the bottom. Then you float with your eyes closed, until the river washes you up on an asphalt shore, where two boys play baseball at dusk.

You feel your time is drawing short. You won't be able to stay here long.

>swim in lake
You dive deep into the lake. Looking up, you see a bright orange sky.

>take bat
Through pantomime you demonstrate to the boys that you are an exceptional baseball player. They gladly let you join in, and you play for some time.

>use bat
Through pantomime you demonstrate to the boys that you are an exceptional baseball player. They gladly let you join in, and you play for some time.

>climb staris
You can't see any such thing.

>climb stairs
You climb the stairs to find yourself at the edge of Lake Eunpa, a man-made resevoir built by the Japanese that now serves as a beautiful lake, surrounded by walkways.

>x walkways
Time is short: you must leave this place.

* * *

>climb stairs
You climb the stairs to find yourself at the edge of Lake Eunpa, a man-made resevoir built by the Japanese that now serves as a beautiful lake, surrounded by walkways.

>run on walkways
You are now running on the walkways. Around and around in circles.

>drink
What do you want to drink?

>water
You can't reach into Maisan Mountain.

>drink resevoir
You can't see any such thing.

>drink eunpa
You can't reach into Maisan Mountain.

* * *

>n
Sandlot
You follow the stream, walking north, until the stream becomes a river and you can no longer touch the bottom. Then you float with your eyes closed, until the river washes you up on an asphalt shore, where two boys play baseball at dusk.

You feel your time is drawing short. You won't be able to stay here long.

>drink
What do you want to drink?

* * *

>water
You can't reach into Maisan Mountain.

>drink water
You can't reach into Maisan Mountain.

>drink eunpa
You can't reach into Maisan Mountain.

* * *

>n
A Group of Boys
You make your way quickly north, but a group of smiling boys jumps in front of you.

"Kimchi! My name is Bae! Hello! I love you! My name is Chin-ho!"

>n
A Pavilion
You manage to break away from the group of boys. Running now, panting, you've hardly any time left. Glancing to your right, you see a man helping a young boy take off his shoes before entering a pavilion.

>n
Leaving
You're flying now, faster than you've ever flown before... the air that streams by you feels like a thick liquid. Glancing over your shoulder, your last glimpse of Korea is a girl in red stripes, holding an umbrella.

And then she's gone.

                 Being There. A notgame for Korea, created by Jordan Magnuson.

                                        GameTrekking.com

* * *

>n
A Stream
You run far this time, and come upon a stream where a father plays with his two daughters.

>taste
What do you want to taste?

>stream
You bend down, place your head in the stream, and open your mouth. The water rushes into mouth, down your throat, and fills your stomach. Bloated, you fall over with a splash. You are now reclining in the stream.

>l
A Stream (in the stream)
You run far this time, and come upon a stream where a father plays with his two daughters.

>l
A Stream (in the stream)
You run far this time, and come upon a stream where a father plays with his two daughters.

* * *

>n
A Stream
You run far this time, and come upon a stream where a father plays with his two daughters.

>say hello
(addressing the Korean girls)
"Hello my name is Ae-young nice to meat you," says the girl in the striped suit, then giggles.

>my name is jordan
That's not a verb I recognize.

>say my name is jordan
Whom do you want to say that to?

>girls
There is no reply.

* * *

>n
A Stream
You run far this time, and come upon a stream where a father plays with his two daughters.

>jump in stream
You are now jumping in the stream. You take a deep breath.

>drink water
You bend down, place your head in the stream, and open your mouth. The water rushes into mouth, down your throat, and fills your stomach. Bloated, you fall over with a splash. You are now reclining in the stream.

* * *

>n
Kimchi Pots
Walking north you come upon some gaint Kimchi pots.

If there was kimchi in one of those pots you could eat it... you could put it in your mouth and let the spices soak your tongue.

You could climb into one of the pots and sing until your voice was hoarse.

You could stand on top of one of them and jump up and down until someone made you stop.

You could do a million things. Or nothing at all.

>stand in pot
You are now standing on a closed kimchi pot. You feel tall.

>open pot
You open a kimchi pot, revealing more kimchi than you know what to do with.

>stand in pot
(getting off the closed kimchi pot)
You are now standing in an open kimchi pot; the strong spicy odor surrounds you, and the cabbage is soft beneath your bare feet.

>l
Kimchi Pots (in the open kimchi pot)
Walking north you come upon some gaint Kimchi pots.

If there was kimchi in one of those pots you could eat it... you could put it in your mouth and let the spices soak your tongue.

You could climb into one of the pots and sing until your voice was hoarse.

You could stand on top of one of them and jump up and down until someone made you stop.

You could do a million things. Or nothing at all.

In the open kimchi pot you can see a small mountain of kimchi.

>showme supporter-pot
closed kimchi pot - spot
location: in Kimchi Pots
unlit; inedible; fixed in place; scenery; singular-named; improper-named; neuter; ordinarily enumerated; seen; unfamiliar; unswingable; one-of-many; not drinkable; weak_smelling; soft_sounding
printed name: closed kimchi pot
indefinite article: a
printed plural name: spots
feeling: The pots are glazed, and feel smooth and curvy.
flavor: The pots themselves don't taste like much.
odor: strongly spiced cabbage
sound: pots full of cabbage
enterable
carrying capacity: 100
posture: standing

>showme open pot
open kimchi pot - open container
    yourself - person
        your head (part of yourself) - head
        your nose (part of yourself) - nose
        your eyes (part of yourself) - eyes
        your eye (part of yourself) - eye
        your ears (part of yourself) - ears
        your ear (part of yourself) - ear
        your chin (part of yourself) - chin
        your hair (part of yourself) - hair
        your face (part of yourself) - face
        your hands (part of yourself) - hands
        your hand (part of yourself) - hand
        your fingers (part of yourself) - fingers
        your finger (part of yourself) - finger
        your legs (part of yourself) - legs
        your leg (part of yourself) - leg
        your feet (part of yourself) - feet
        your foot (part of yourself) - foot
        your knees (part of yourself) - knees
        your knee (part of yourself) - knee
        your Toes (part of yourself) - Toes
        your toe (part of yourself) - toe
    kimchi - kimchi food
location: in Kimchi Pots
unlit; inedible; fixed in place; scenery; singular-named; improper-named; neuter; ordinarily enumerated; seen; unfamiliar; unswingable; one-of-many; not drinkable; weak_smelling; soft_sounding
description: Large pots made for holding Korea's favorite food. Big enough to climb into... or stand on.
printed name: open kimchi pot
printed plural name: containers
feeling: normal
flavor: normal
odor: normal
sound: silence
enterable; opaque; open; openable; unlocked
carrying capacity: 100
known-key: no-key
posture: seated

>sing
You are now singing in an open kimchi pot. You feel a breeze behind you.

>l
Kimchi Pots (in the open kimchi pot)
Walking north you come upon some gaint Kimchi pots.

If there was kimchi in one of those pots you could eat it... you could put it in your mouth and let the spices soak your tongue.

You could climb into one of the pots and sing until your voice was hoarse.

You could stand on top of one of them and jump up and down until someone made you stop.

You could do a million things. Or nothing at all.

In the open kimchi pot you can see a small mountain of kimchi.

>get in pot
But you're already in the open kimchi pot.

>get out
You get out of the open kimchi pot.

Kimchi Pots
Walking north you come upon some gaint Kimchi pots.

If there was kimchi in one of those pots you could eat it... you could put it in your mouth and let the spices soak your tongue.

You could climb into one of the pots and sing until your voice was hoarse.

You could stand on top of one of them and jump up and down until someone made you stop.

You could do a million things. Or nothing at all.

>get in pot
You get into the open kimchi pot.

In the open kimchi pot you can see a small mountain of kimchi.

>l
Kimchi Pots (in the open kimchi pot)
Walking north you come upon some gaint Kimchi pots.

If there was kimchi in one of those pots you could eat it... you could put it in your mouth and let the spices soak your tongue.

You could climb into one of the pots and sing until your voice was hoarse.

You could stand on top of one of them and jump up and down until someone made you stop.

You could do a million things. Or nothing at all.

In the open kimchi pot you can see a small mountain of kimchi.

>sing
You are now singing in an open kimchi pot. You belt it out like a good one.

>eat kimchi
You take a bite of the kimchi. Spicy and delicious.

>close pot
You close the open kimchi pot.

It is now pitch dark in here!

>sing
You are already singing.

>open pot
You open a kimchi pot, revealing more kimchi than you know what to do with.

Kimchi Pots (in the open kimchi pot)
Walking north you come upon some gaint Kimchi pots.

If there was kimchi in one of those pots you could eat it... you could put it in your mouth and let the spices soak your tongue.

You could climb into one of the pots and sing until your voice was hoarse.

You could stand on top of one of them and jump up and down until someone made you stop.

You could do a million things. Or nothing at all.

In the open kimchi pot you can see a small mountain of kimchi.

>get out
You get out of the open kimchi pot.

Kimchi Pots
Walking north you come upon some gaint Kimchi pots.

If there was kimchi in one of those pots you could eat it... you could put it in your mouth and let the spices soak your tongue.

You could climb into one of the pots and sing until your voice was hoarse.

You could stand on top of one of them and jump up and down until someone made you stop.

You could do a million things. Or nothing at all.

>close pot
You close the open kimchi pot.

>eat kimchi
You'll need to open a pot first.

>x kimchi
The kimchi is inside of those closed pots.

>x ground
It's the ground.

>x sky
As you peer at the sky it seems to dance.

>x sky
As you peer at the sky it seems to dance.

>n
A Stream
You run far this time, and come upon a stream where a father plays with his two daughters.

>swim in stream
Some might say the water's a bit shallow for swimming, but that doesn't stop you from diving in head first and splashing about like a maniac.

>l
A Stream
You run far this time, and come upon a stream where a father plays with his two daughters.

>sing in stream
You are now singing in the stream. Life is good.

>l
A Stream (in the stream)
You run far this time, and come upon a stream where a father plays with his two daughters.

>dance in stream
You are now dancing in the stream. You spin and you spin, until you can't see straight.

>run in stream
You are now running in the stream.

>walk in sream
You can't see any such thing.

>walk in stream
You are now walking in the stream.

>splash visor
You splash visors vigorously, getting wonderfully soaked in the process.

>x leg
Which do you mean, the Korean man's leg, the Korean girls's leg, or your leg?

>man's leg
You do not normally need to refer to specific parts of the body.

>x leg
Which do you mean, the Korean man's leg, the Korean girls's leg, or your leg?

>man
You do not normally need to refer to specific parts of the body.

>x leg
Which do you mean, the Korean man's leg, the Korean girls's leg, or your leg?

>mine
You do not normally need to refer to specific parts of the body.

* * *

>n
Kimchi Pots
Walking north you come upon some gaint Kimchi pots.

If there was kimchi in one of those pots you could eat it... you could put it in your mouth and let the spices soak your tongue.

You could climb into one of the pots and sing until your voice was hoarse.

You could stand on top of one of them and jump up and down until someone made you stop.

You could do a million things. Or nothing at all.

>s
A Stream
You run far this time, and come upon a stream where a father plays with his two daughters.

>s
Sandlot
You follow the stream, walking south, until the stream becomes a river and you can no longer touch the bottom. Then you float with your eyes closed, until the river washes you up on an asphalt shore, where two boys play baseball at dusk.

You feel your time is drawing short. You won't be able to stay here long.

>n
A Group of Boys
You make your way quickly north, but a group of smiling boys jumps in front of you.

"Kimchi! My name is Bae! Hello! I love you! My name is Chin-ho!"

>s
A Pavilion
You manage to break away from the group of boys. Running now, panting, you've hardly any time left. Glancing to your right, you see a man helping a young boy take off his shoes before entering a pavilion.

>n
Leaving
You're flying now, faster than you've ever flown before... the air that streams by you feels like a thick liquid. Glancing over your shoulder, your last glimpse of Korea is a girl in red stripes, holding an umbrella.

And then she's gone.

                 Being There. A notgame for Korea, created by Jordan Magnuson.

                                        GameTrekking.com

* * *

>n
Kimchi Pots
Walking north you come upon some gaint Kimchi pots.

If there was kimchi in one of those pots you could eat it... you could put it in your mouth and let the spices soak your tongue.

You could climb into one of the pots and sing until your voice was hoarse.

You could stand on top of one of them and jump up and down until someone made you stop.

You could do a million things. Or nothing at all.

>search pots
You'll need to open one first.

>open pot
You open a kimchi pot, revealing more kimchi than you know what to do with.

>search pots
You find a boatload of kimchi--what a surprise!

>n
A Stream
You run far this time, and come upon a stream where a father plays with his two daughters.

>taste stream
Pretty much what you would expect.

>drink
(the stream)
You bend down, place your head in the stream, and open your mouth. The water rushes into mouth, down your throat, and fills your stomach. Bloated, you fall over with a splash. You are now reclining in the stream.

>smell stream
Smells the same as it did yesterday.

>listen to stream
Silence.

* * *

>n
Kimchi Pots
Walking north you come upon some gaint Kimchi pots.

If there was kimchi in one of those pots you could eat it... you could put it in your mouth and let the spices soak your tongue.

You could climb into one of the pots and sing until your voice was hoarse.

You could stand on top of one of them and jump up and down until someone made you stop.

You could do a million things. Or nothing at all.

>eat all ofit
You'll need to open a pot first (and hope that the kimchi is actually in there).

>eat all of it
You'll need to open a pot first (and hope that the kimchi is actually in there).

>open pot
You open a kimchi pot, revealing more kimchi than you know what to do with.

>eat all of it
Pretty much what you would expect.

>eat it
Pretty much what you would expect.

>eat
What do you want to eat?

>it
Pretty much what you would expect.

>taste it
Pretty much what you would expect.

>n
A Stream
You run far this time, and come upon a stream where a father plays with his two daughters.

>eat it
Pretty much what you would expect.

>taste it
Pretty much what you would expect.

>taste water
You bend down, place your head in the stream, and open your mouth. The water rushes into your mouth, down your throat, and fills your stomach. Bloated, you fall over with a splash. You are now reclining in the stream.

>showme it
stream - open container
    yourself - person
        your head (part of yourself) - head
        your nose (part of yourself) - nose
        your eyes (part of yourself) - eyes
        your eye (part of yourself) - eye
        your ears (part of yourself) - ears
        your ear (part of yourself) - ear
        your chin (part of yourself) - chin
        your hair (part of yourself) - hair
        your face (part of yourself) - face
        your hands (part of yourself) - hands
        your hand (part of yourself) - hand
        your fingers (part of yourself) - fingers
        your finger (part of yourself) - finger
        your legs (part of yourself) - legs
        your leg (part of yourself) - leg
        your feet (part of yourself) - feet
        your foot (part of yourself) - foot
        your knees (part of yourself) - knees
        your knee (part of yourself) - knee
        your Toes (part of yourself) - Toes
        your toe (part of yourself) - toe
location: in A Stream
unlit; inedible; fixed in place; scenery; singular-named; improper-named; neuter; ordinarily enumerated; seen; unfamiliar; unswingable; not-one-of-many; not drinkable; weak_smelling; soft_sounding
description: A clear flowing stream that's just calling out to you to sit down in it and ponder life for a while.
printed name: stream
printed plural name: containers
feeling: Liquid refreshment.
flavor: You bend down, place your head in the stream, and open your mouth. The water rushes into your mouth, down your throat, and fills your stomach. Bloated, you fall over with a splash. You are now reclining in the stream.
odor: clean water, without a hint of polution or grime
sound: a faucet on high
enterable; opaque; open; unopenable; unlocked
carrying capacity: 100
known-key: no-key
posture: seated

>taste it
You bend down, place your head in the stream, and open your mouth. The water rushes into your mouth, down your throat, and fills your stomach. Bloated, you fall over with a splash. You are now reclining in the stream.

>n
(first leaving the stream)

Sandlot
You follow the stream, walking north, until the stream becomes a river and you can no longer touch the bottom. Then you float with your eyes closed, until the river washes you up on an asphalt shore, where two boys play baseball at dusk.

You feel your time is drawing short. You won't be able to stay here long.

>showme it
walkways - spot
location: in Sandlot
unlit; inedible; fixed in place; scenery; singular-named; improper-named; neuter; ordinarily enumerated; seen; unfamiliar; unswingable; not-one-of-many; not drinkable; weak_smelling; soft_sounding
description: Walkways surround the lake.
printed name: walkways
printed plural name: spots
feeling: normal
flavor: normal
odor: normal
sound: silence
enterable
carrying capacity: 100
posture: standing

>taste it
Pretty much what you would expect.

* * *

>open pot
You open a kimchi pot, revealing more kimchi than you know what to do with.

>showme it
open kimchi pot - open container
    kimchi - kimchi food
location: in Kimchi Pots
unlit; inedible; fixed in place; scenery; singular-named; improper-named; neuter; ordinarily enumerated; seen; unfamiliar; unswingable; one-of-many; not drinkable; weak_smelling; soft_sounding
description: Large pots made for holding Korea's favorite food. Big enough to climb into... or stand on.
printed name: open kimchi pot
printed plural name: containers
feeling: normal
flavor: normal
odor: normal
sound: silence
enterable; opaque; open; openable; unlocked
carrying capacity: 100
known-key: no-key
posture: seated

* * *

>open pot
You open a kimchi pot, revealing more kimchi than you know what to do with.

>get in pot
You get into the open kimchi pot.

In the open kimchi pot you can see a small mountain of kimchi.

>sing
You are now singing in an open kimchi pot. A trumpet sounds in the distance.

>sing in pot
But you're already in the open kimchi pot.
You are now singing in an open kimchi pot. The cabbage resonates around you.

>open pot
That's already open.

>get in pot
But you're already in the open kimchi pot.

>lie down
You are now reclining in an open kimchi pot. You rest your head on the earth and close your eyes.

* * *

>n
Kimchi Pots
Walking north you come upon some gaint Kimchi pots.

If there was kimchi in one of those pots you could eat it... you could put it in your mouth and let the spices soak your tongue.

You could climb into one of the pots and sing until your voice was hoarse.

You could stand on top of one of them and jump up and down until someone made you stop.

You could do a million things. Or nothing at all.

>eat it
You'll need to open a pot first (and hope that the kimchi is actually in there).

>open pot
You open a kimchi pot, revealing more kimchi than you know what to do with.

>eat it
Pretty much what you would expect.

* * *

>n
Kimchi Pots
Walking north you come upon some gaint Kimchi pots.

If there was kimchi in one of those pots you could eat it... you could put it in your mouth and let the spices soak your tongue.

You could climb into one of the pots and sing until your voice was hoarse.

You could stand on top of one of them and jump up and down until someone made you stop.

You could do a million things. Or nothing at all.

>showme the kimchi
The kimchi is (presumably) inside of those closed pots.

>open pot
You open a kimchi pot, revealing more kimchi than you know what to do with.

* * *

>eat it
Pretty much what you would expect.

>eat all of it
Pretty much what you would expect.

* * *

>n
Kimchi Pots
Walking north you come upon some gaint Kimchi pots.

If there was kimchi in one of those pots you could eat it... you could put it in your mouth and let the spices soak your tongue.

You could climb into one of the pots and sing until your voice was hoarse.

You could stand on top of one of them and jump up and down until someone made you stop.

You could do a million things. Or nothing at all.

>eat all of it
You'll need to open a pot first (and hope that the kimchi is actually in there).

* * *

>open pot
You open a kimchi pot, revealing more kimchi than you know what to do with.

>eat all of it
If you want to eat the kimchi, try the command "eat kimchi".

>eat kimchi
You take a bite of the kimchi. Spicy and delicious.

* * *

>n
Kimchi Pots
Walking north you come upon some gaint Kimchi pots.

If there was kimchi in one of those pots you could eat it... you could put it in your mouth and let the spices soak your tongue.

You could climb into one of the pots and sing until your voice was hoarse.

You could stand on top of one of them and jump up and down until someone made you stop.

You could do a million things. Or nothing at all.

>lie in pot
The pots are a bit small to lie on.

>lie on pot
The pots are a bit small to lie on.

>dance on pot
You'll need to open one of the pots first.

>sit on pot
You are now sitting on one of the closed kimchi pots. You feel the power of kimchi beneath you.

>stand on pot
You are now standing on a closed kimchi pot. Just like when you were a kid... or maybe not.

>open pot
You open a kimchi pot, revealing more kimchi than you know what to do with.

>dance in pot
(getting off the closed kimchi pot)
You are now dancing in an open kimchi pot. A contemporary interpretation of the scenery around you.

>l
Kimchi Pots (in the open kimchi pot)
If there was kimchi in one of those pots you could eat it... you could put it in your mouth and let the spices soak your tongue.

You could climb into one of the pots and sing until your voice was hoarse.

You could stand on top of one of them and jump up and down until someone made you stop.

You could do a million things. Or nothing at all.

In the open kimchi pot you can see a small mountain of kimchi.

>enter pot
But you're already in the open kimchi pot.

>dance
You are already dancing.

>dance
You are already dancing.

>sit
You are now seated in an open kimchi pot.

>dance
You are now dancing in an open kimchi pot. Leaping wildly, like a gazelle.

>sing
You are now singing in an open kimchi pot. No one to say if you're any good or not.

>sing
You are already singing.

* * *

>n
Kimchi Pots
Walking north you come upon some gaint Kimchi pots.

If there was kimchi in one of those pots you could eat it... you could put it in your mouth and let the spices soak your tongue.

You could climb into one of the pots and sing until your voice was hoarse.

You could stand on top of one of them and jump up and down until someone made you stop.

You could do a million things. Or nothing at all.

>jump on pot
You jump up and down like a maniac on the ceramic lid of a kimchi pot. You better hope it doesn't break under you!

You'll need to open one of the pots first.

>l
Kimchi Pots
If there was kimchi in one of those pots you could eat it... you could put it in your mouth and let the spices soak your tongue.

You could climb into one of the pots and sing until your voice was hoarse.

You could stand on top of one of them and jump up and down until someone made you stop.

You could do a million things. Or nothing at all.

>jump
You jump on the spot.

* * *

>n
Kimchi Pots
Walking north you come upon some gaint Kimchi pots.

If there was kimchi in one of those pots you could eat it... you could put it in your mouth and let the spices soak your tongue.

You could climb into one of the pots and sing until your voice was hoarse.

You could stand on top of one of them and jump up and down until someone made you stop.

You could do a million things. Or nothing at all.

>lie on pot
You jump onto a closed pot.

>get on pot
But you're already on the closed kimchi pot.

You jump onto a closed pot.

>jump
You jump up and down like a maniac on the ceramic lid of the kimchi pot. You better hope it doesn't break under you!

>lie down
The pots are a bit small to lie on.

>get off
You get off the closed kimchi pot.

Kimchi Pots
If there was kimchi in one of those pots you could eat it... you could put it in your mouth and let the spices soak your tongue.

You could climb into one of the pots and sing until your voice was hoarse.

You could stand on top of one of them and jump up and down until someone made you stop.

You could do a million things. Or nothing at all.

>lie down
You are now reclining. Face on down, particles colliding with your face.

>get on ground
You get into the ground.

>l
Kimchi Pots (in the ground)
If there was kimchi in one of those pots you could eat it... you could put it in your mouth and let the spices soak your tongue.

You could climb into one of the pots and sing until your voice was hoarse.

You could stand on top of one of them and jump up and down until someone made you stop.

You could do a million things. Or nothing at all.

>dance
You are now dancing on the ground. Everything around you seems to drip color.

>l
Kimchi Pots (in the ground)
If there was kimchi in one of those pots you could eat it... you could put it in your mouth and let the spices soak your tongue.

You could climb into one of the pots and sing until your voice was hoarse.

You could stand on top of one of them and jump up and down until someone made you stop.

You could do a million things. Or nothing at all.

* * *

>n
Kimchi Pots
Walking north you come upon some gaint Kimchi pots.

If there was kimchi in one of those pots you could eat it... you could put it in your mouth and let the spices soak your tongue.

You could climb into one of the pots and sing until your voice was hoarse.

You could stand on top of one of them and jump up and down until someone made you stop.

You could do a million things. Or nothing at all.

>get on ground
You get into the ground.

>get on pot
(getting out of the ground)
You get onto the closed kimchi pot.

You jump onto a closed pot.

>lie on pot
The pots are a bit small to lie on.

>open pot
You open a kimchi pot, revealing more kimchi than you know what to do with.

* * *

>stand in pot
(getting off the closed kimchi pot)
You are now standing in an open kimchi pot; the strong spicy odor surrounds you, and the cabbage is soft beneath your bare feet.

>dance
You are now dancing in an open kimchi pot. Twirling ballet style.

>stand
You are now standing in an open kimchi pot. You imagine that you are a needle, pointed towards the sky.

* * *

>n
Kimchi Pots
Walking north you come upon some gaint Kimchi pots.

If there was kimchi in one of those pots you could eat it... you could put it in your mouth and let the spices soak your tongue.

You could climb into one of the pots and sing until your voice was hoarse.

You could stand on top of one of them and jump up and down until someone made you stop.

You could do a million things. Or nothing at all.

>sit on pot
You are now sitting on one of the closed kimchi pots. You feel the power of kimchi beneath you.

>stand up
You continue to stand.

>l
Kimchi Pots (on the closed kimchi pot)
If there was kimchi in one of those pots you could eat it... you could put it in your mouth and let the spices soak your tongue.

You could climb into one of the pots and sing until your voice was hoarse.

You could stand on top of one of them and jump up and down until someone made you stop.

You could do a million things. Or nothing at all.

>sit on pot
But you're already on the closed kimchi pot.
You are now sitting on one of the closed kimchi pots. You feel the power of kimchi beneath you.

>stand on pot
You are now standing on a closed kimchi pot. You imagine that you are a needle, pointed towards the sky.

>sit
You are now sitting on one of the closed kimchi pots. You feel the power of kimchi beneath you.

You are now seated on a closed kimchi pot.

>l
Kimchi Pots (on the closed kimchi pot)
If there was kimchi in one of those pots you could eat it... you could put it in your mouth and let the spices soak your tongue.

You could climb into one of the pots and sing until your voice was hoarse.

You could stand on top of one of them and jump up and down until someone made you stop.

You could do a million things. Or nothing at all.

>sit
You are now sitting on one of the closed kimchi pots. You feel the power of kimchi beneath you.

You continue to sit. You wonder how you ended up here.

>stand on pot
You are now standing on a closed kimchi pot. The breeze ruffles your hair.

>sit
You are now sitting on one of the closed kimchi pots. You feel the power of kimchi beneath you.

You are now seated on a closed kimchi pot.

* * *

>n
Kimchi Pots
Walking north you come upon some gaint Kimchi pots.

If there was kimchi in one of those pots you could eat it... you could put it in your mouth and let the spices soak your tongue.

You could climb into one of the pots and sing until your voice was hoarse.

You could stand on top of one of them and jump up and down until someone made you stop.

You could do a million things. Or nothing at all.

>dance on pot
You are now dancing on a closed kimchi pot. This would probably be called a sword dance, if you had a sword.

>stand
You are now standing on a closed kimchi pot. You feel a breeze behind you.

>stand
You continue to stand.

>jump
You jump up and down like a maniac on the ceramic lid of the kimchi pot. You better hope it doesn't break under you!

* * *

>jump
The ceramic lid has had all the abuse it can take. It breaks. You land in a mountain of kimchi.

>stand
You continue to stand.

>dance
Some might say the pots are a bit small for dancing in, but you wiggle around as best you can.

>dance in pot
But you're already in the kimchi pot.

You continue to dance. You wonder how you ended up here.
Some might say the pots are a bit small for dancing in, but you wiggle around as best you can.

>get out
You get out of the kimchi pot.

Kimchi Pots
If there was kimchi in one of those pots you could eat it... you could put it in your mouth and let the spices soak your tongue.

You could climb into one of the pots and sing until your voice was hoarse.

You could stand on top of one of them and jump up and down until someone made you stop.

You could do a million things. Or nothing at all.

>dance in pot
Some might say the pots are a bit small for dancing in, but you wiggle around as best you can.

>dance
Some might say the pots are a bit small for dancing in, but you wiggle around as best you can.

You continue to dance. A beam of sunlight crosses in front of you.

* * *

>n
Temple Spring
You wander north for hours, searching for you don't know what. And then you find it: A fresh spring at the temple of the nirvana fish, spouting clean, cold water from a bamboo chute.

The water flows onto a stone platform, then over the edge, and away.

>x cup
Communal plastic cups are a norm in Korea.

>take cup
You take one of the cups and dip it into the stream of water; then you drink a long draught.

* * *

>n
Temple Spring
You wander north for hours, searching for you don't know what. And then you find it: A fresh spring at the temple of the nirvana fish, spouting clean, cold water from a bamboo chute.

The water flows onto a stone platform, then over the edge, and away.

>fly
You are now flying. You feel millions of Nitrogen and Oxygen particles hitting your skin.

>d
But you aren't in anything at the moment.

>d
But you aren't in anything at the moment.

>wash
You have a nice bathe. You feel cleaner.

>wash cup
You wash the cup.

>wash shoot
You wash the bamboo tubes.

>was shute
That's not a verb I recognize.

>wash shute
You wash the bamboo tubes.

>x chute
Tubes made from bamboo.

>x cup
Communal plastic cups are a norm in Korea.

>smell cup
Smells the same as it did yesterday.

>taste cup
Ignoring the stream of fresh water, you attempt to eat one of the cups. It tastes like plastic.

>smell water
Smells like damp bamboo.

>smell stone
Smells like damp rock.

>touch stone
Feels rough like the stone that it is.

>n
(first standing up)

Kimchi Pots
Walking north you come upon some gaint Kimchi pots.

If there was kimchi in one of those pots you could eat it... you could put it in your mouth and let the spices soak your tongue.

You could climb into one of the pots and sing until your voice was hoarse.

You could stand on top of one of them and jump up and down until someone made you stop.

You could do a million things. Or nothing at all.

>eat kimchi
You'll need to open a pot first.

>x kimchi
You can't see any such thing.

>open pot
You open a kimchi pot, revealing more kimchi than you know what to do with.

>stand on pot
You are now standing on a closed kimchi pot. You feel tall.

>stand in pot
You are now standing in an open kimchi pot; the strong spicy odor surrounds you, and the cabbage is soft beneath your bare feet.

>sing
You are now singing on a closed kimchi pot.

>showme supporter-pot
closed kimchi pot - spot
    yourself - person
        your head (part of yourself) - head
        your nose (part of yourself) - nose
        your eyes (part of yourself) - eyes
        your eye (part of yourself) - eye
        your ears (part of yourself) - ears
        your ear (part of yourself) - ear
        your chin (part of yourself) - chin
        your hair (part of yourself) - hair
        your face (part of yourself) - face
        your hands (part of yourself) - hands
        your hand (part of yourself) - hand
        your fingers (part of yourself) - fingers
        your finger (part of yourself) - finger
        your legs (part of yourself) - legs
        your leg (part of yourself) - leg
        your feet (part of yourself) - feet
        your foot (part of yourself) - foot
        your knees (part of yourself) - knees
        your knee (part of yourself) - knee
        your Toes (part of yourself) - Toes
        your toe (part of yourself) - toe
location: in Kimchi Pots
unlit; inedible; fixed in place; scenery; singular-named; improper-named; neuter; ordinarily enumerated; seen; unfamiliar; unswingable; one-of-many; not drinkable; weak_smelling; soft_sounding
printed name: closed kimchi pot
indefinite article: a
printed plural name: spots
feeling: The pots are glazed, and feel smooth and curvy.
flavor: The pots themselves don't taste like much.
odor: strongly spiced cabbage
sound: pots full of cabbage
enterable
carrying capacity: 100
posture: standing

>sing in pot
You are now singing in an open kimchi pot. The cabbage resonates around you.

>sing
You are already singing.

>lie down
You can't take that position on a closed kimchi pot.

* * *

>n
Temple Spring
You wander north for hours, searching for you don't know what. And then you find it: A fresh spring at the temple of the nirvana fish, spouting clean, cold water from a bamboo chute.

The water flows onto a stone platform, then over the edge, and away.

>fill cup
You take one of the cups and dip it into the stream of water; then you drink a long draught.

>fill rock
You can't see any such thing.

>fill water
You can't see any such thing.

>n
Kimchi Pots
Walking north you come upon some gaint Kimchi pots.

If there was kimchi in one of those pots you could eat it... you could put it in your mouth and let the spices soak your tongue.

You could climb into one of the pots and sing until your voice was hoarse.

You could stand on top of one of them and jump up and down until someone made you stop.

You could do a million things. Or nothing at all.

>fill kimcih
You can't see any such thing.

>fill
You can't see any such thing.

* * *

>n
Temple Spring
You wander north for hours, searching for you don't know what. And then you find it: A fresh spring at the temple of the nirvana fish, spouting clean, cold water from a bamboo chute.

The water flows onto a stone platform, then over the edge, and away.

>put water in cup
You take one of the cups and dip it into the stream of water; then you drink a long draught.

>fill cup
You take one of the cups and dip it into the stream of water; then you drink a long draught.

>fill water
You take one of the cups and dip it into the stream of water; then you drink a long draught.

>n
Kimchi Pots
Walking north you come upon some gaint Kimchi pots.

If there was kimchi in one of those pots you could eat it... you could put it in your mouth and let the spices soak your tongue.

You could climb into one of the pots and sing until your voice was hoarse.

You could stand on top of one of them and jump up and down until someone made you stop.

You could do a million things. Or nothing at all.

>kick pots
That's not a verb I recognize.

>hit pots
Violence isn't the answer to this one.

>kick pots
That's not a verb I recognize.

* * *

>hit pots
Violence isn't the answer to this one.

>search pot
(first opening the open kimchi pot)
You'll need to open it first.

>x pot
Large pots made for holding Korea's favorite food. Big enough to climb into... or stand on.

>x open pot
Large pots made for holding Korea's favorite food. Big enough to climb into... or stand on.

>x closed pot
You can't see any such thing.

>x supporter pot
I only understood the first part of that-- trying anyway.

(retrying as if you'd typed "x supporter.")
You see nothing special about the closed kimchi pot.

* * *

>n
Temple Spring
You wander north for hours, searching for you don't know what. And then you find it: A fresh spring at the temple of the nirvana fish, spouting clean, cold water from a bamboo chute.

The water flows onto a stone platform, then over the edge, and away.

>kiss stone
You can only do that to something animate.

>kiss stone
You can only do that to something animate.

>feel bamboo
Gourd-like, natural, strong, and smooth.

>touch bamboo
Gourd-like, natural, strong, and smooth.

>taste bamboo
The bamboo is hard, but you manage to bite a small piece off the end of the tube, and suck on it for a while. You feel oddly at peace with the world.

>wash me
You splash water on your face, your neck, your arms, your legs. It trickles over your skin, displacing sweat and dirt slowly. but surely.

>n
Kimchi Pots
Walking north you come upon some gaint Kimchi pots.

If there was kimchi in one of those pots you could eat it... you could put it in your mouth and let the spices soak your tongue.

You could climb into one of the pots and sing until your voice was hoarse.

You could stand on top of one of them and jump up and down until someone made you stop.

You could do a million things. Or nothing at all.

>dance on pot
You are now dancing on a closed kimchi pot.

>dance in pot
You are now dancing on a closed kimchi pot.

>open pot
You open a kimchi pot, revealing more kimchi than you know what to do with.

>dance on pot
You are now dancing on a closed kimchi pot. Sort of a solo waltz.

>dance in pot
(getting off the closed kimchi pot)
Some might say the pots are a bit small for dancing in, but you wiggle around as best you can.

>l
Kimchi Pots (in the open kimchi pot)
If there was kimchi in one of those pots you could eat it... you could put it in your mouth and let the spices soak your tongue.

You could climb into one of the pots and sing until your voice was hoarse.

You could stand on top of one of them and jump up and down until someone made you stop.

You could do a million things. Or nothing at all.

In the open kimchi pot you can see a small mountain of kimchi.

* * *

>enter pot
But you're already in the open kimchi pot.

>dance
You are now dancing in an open kimchi pot. Acro style.

>dance in pot
But you're already in the open kimchi pot.
Some might say the pots are a bit small for dancing in, but you wiggle around as best you can.

* * *

>n
Napo Field
You fly north until you can fly no more. Then you land here, in a middle school soccer field.

The air is cool and crisp to the touch. Autumn has come, and the birds will be here soon, stopping in this field on their way south. Or maybe they've already been.

There are some parallel bars in the distance. You could swing from those bars, or climb that barren tree. Or you could just keep going north.

>s
Maisan Mountain
After traveling south for some time you find yourself atop Maisain Mountain, looking out over the farmland of North Jeolla. There's a golf course down there that you might just be able to touch, as well some man-made lakes and Geum River, winding itself towards the Yellow Sea.

You could dance in the sky here, if you wanted. You could probably fly.

>n
Napo Field
You fly north until you can fly no more. Then you land here, in a middle school soccer field.

The air is cool and crisp to the touch. Autumn has come, and the birds will be here soon, stopping in this field on their way south. Or maybe they've already been.

There are some parallel bars in the distance. You could swing from those bars, or climb that barren tree. Or yoo could just keep going north.

* * *

>n
Sandlot
You follow the stream, walking north, until the stream becomes a river and you can no longer touch the bottom. Then you float with your eyes closed, until the river washes you up on an asphalt shore, where two boys play baseball at dusk.

You feel your time is drawing short. You won't be able to stay here long.

>drink
(Lake Eunpa)
You can't reach into Maisan Mountain.

>drink water
You can't reach into Maisan Mountain.

* * *

>n
Napo Field
You fly north until you can fly no more. Then you land here, in a middle school soccer field.

The air is cool and crisp to the touch. Autumn has come, and the birds will be here soon, stopping in this field on their way south. Or maybe they've already been.

There are some parallel bars in the distance. You could swing from those bars, or climb that barren tree. Or you could just keep going north.

>climb bars
You swing around and around and around.

>climb on bars
You swing around and around and around.

* * *

>n
Napo Field
You fly north until you can fly no more. Then you land here, in a middle school soccer field.

The air is cool and crisp to the touch. Autumn has come, and the birds will be here soon, stopping in this field on their way south. Or maybe they've already been.

There are some parallel bars in the distance. You could swing from those bars, or climb that barren tree. Or you could just keep going north.

>swing on bars
You swing around and around and around.

>stand on bars
You are now standing on the parallel bars. You feel tall.

>sit on bars
You can't take that position on the parallel bars.

>dance on bars
You are now dancing on the parallel bars. You spin and you spin, until you can't see straight.

>sing on bars
You can't take that position on the parallel bars.

>l
Napo Field (on the parallel bars)
You fly north until you can fly no more. Then you land here, in a middle school soccer field.

The air is cool and crisp to the touch. Autumn has come, and the birds will be here soon, stopping in this field on their way south. Or maybe they've already been.

There are some parallel bars in the distance. You could swing from those bars, or climb that barren tree. Or you could just keep going north.

>swing on bars
You swing around and around and around.

>l
Napo Field (on the parallel bars)
You fly north until you can fly no more. Then you land here, in a middle school soccer field.

The air is cool and crisp to the touch. Autumn has come, and the birds will be here soon, stopping in this field on their way south. Or maybe they've already been.

There are some parallel bars in the distance. You could swing from those bars, or climb that barren tree. Or you could just keep going north.

>d
You let yourself back down to the ground.

>swing on bars
You swing around and around and around.

>l
Napo Field
You fly north until you can fly no more. Then you land here, in a middle school soccer field.

The air is cool and crisp to the touch. Autumn has come, and the birds will be here soon, stopping in this field on their way south. Or maybe they've already been.

There are some parallel bars in the distance. You could swing from those bars, or climb that barren tree. Or you could just keep going north.

* * *

>swing on bars
You swing around and around and around.

>n
(first leaving the parallel bars)

Temple Spring
You wander north for hours, searching for you don't know what. And then you find it: a fresh spring at the temple of the nirvana fish, spouting clean, cold water from a bamboo chute.

The water flows onto a stone platform, then over the edge, and away.

* * *

>l
Napo Field (on the parallel bars)
You fly north until you can fly no more. Then you land here, in a middle school soccer field.

The air is cool and crisp to the touch. Autumn has come, and the birds will be here soon, stopping in this field on their way south. Or maybe they've already been.

There are some parallel bars in the distance. You could swing from those bars, or climb that barren tree. Or you could just keep going north.

>sit down
You can't take that position on the parallel bars.

>get off
You get off the parallel bars.

Napo Field
You fly north until you can fly no more. Then you land here, in a middle school soccer field.

The air is cool and crisp to the touch. Autumn has come, and the birds will be here soon, stopping in this field on their way south. Or maybe they've already been.

There are some parallel bars in the distance. You could swing from those bars, or climb that barren tree. Or you could just keep going north.

* * *

>n
Napo Field
You fly north until you can fly no more. Then you land here, in a middle school soccer field.

The air is cool and crisp to the touch. Autumn has come, and the birds will be here soon, stopping in this field on their way south. Or maybe they've already been.

There are some parallel bars in the distance. You could swing from those bars, or climb that barren tree. Or you could just keep going north.

>l
Napo Field
The air is cool and crisp to the touch. Autumn has come, and the birds will be here soon, stopping in this field on their way south. Or maybe they've already been.

There are some parallel bars in the distance. You could swing from those bars, or climb that barren tree. Or you could just keep going north.

>n
Temple Spring
You wander north for hours, searching for you don't know what. And then you find it: A fresh spring at the temple of the nirvana fish, spouting clean, cold water from a bamboo chute.

The water flows onto a stone platform, then over the edge, and away.

>l
Temple Spring
A fresh spring at the temple of the nirvana fish, spouting clean, cold water from a bamboo chute.

The water flows onto a stone platform, then over the edge, and away.

>n
Kimchi Pots
Walking north you come upon some gaint Kimchi pots.

If there was kimchi in one of those pots you could eat it... you could put it in your mouth and let the spices soak your tongue.

You could climb into one of the pots and sing until your voice was hoarse.

You could stand on top of one of them and jump up and down until someone made you stop.

You could do a million things. Or nothing at all.

>l
Kimchi Pots
If there was kimchi in one of those pots you could eat it... you could put it in your mouth and let the spices soak your tongue.

You could climb into one of the pots and sing until your voice was hoarse.

You could stand on top of one of them and jump up and down until someone made you stop.

You could do a million things. Or nothing at all.

>n
A Stream
You run far this time, and come upon a stream where a father plays with his two daughters.

>l
A Stream
A stream where a father plays with his two daughters.

>n
Sandlot
You follow the stream, walking north, until the stream becomes a river and you can no longer touch the bottom. Then you float with your eyes closed, until the river washes you up on an asphalt shore, where two boys play baseball at dusk.

You feel your time is drawing short. You won't be able to stay here long.

>l
Sandlot
An asphalt lot, where two boys play baseball at dusk.

>n
A Group of Boys
You make your way quickly north, but a group of smiling boys jumps in front of you.

"Kimchi! My name is Bae! Hello! I love you! My name is Chin-ho!"

>l
A Group of Boys
A group of smiling boys stands in front of you, hollering every bit of english they know.

>n
A Pavilion
You manage to break away from the group of boys. Running now, panting, you've hardly any time left. Glancing to your right, you see a man helping a young boy take off his shoes before entering a pavilion.

>l
There is no time to stop now.

>w
Leaving
You're flying now, faster than you've ever flown before... the air that streams by you feels like a thick liquid. Glancing over your shoulder, your last glimpse of Korea is a girl in red stripes, holding an umbrella.

And then she's gone.

>l
Being There. A notgame for Korea, created by Jordan Magnuson.

* * *

>n
Napo Field
You fly north until you can fly no more. Then you land here, in a middle school soccer field.

The air is cool and crisp to the touch. Autumn has come, and the birds will be here soon, stopping in this field on their way south. Or maybe they've already been.

There are some parallel bars in the distance. You could swing from those bars, or climb that barren tree. Or you could just keep going north.

>x barren
You can't see any such thing.

>climb barren trees
You climb to the top of the barren tree. The field looks distant, and small.

You are now seated in the trees. The earth spins slowly.

>climb barren
You can't see any such thing.

>play soccer
You play soccer with an invisible ball... you score!

>play football
In Korea, they actually call it "soccer."

You play soccer with an invisible ball... you score!

>play
You play soccer with an invisible ball... you score!

>climb tree
You are now seated in the trees. You rest your chin on your upraised knees.

* * *

>n
Napo Field
You fly north until you can fly no more. Then you land here, in a middle school soccer field.

The air is cool and crisp to the touch. Autumn has come, and the birds will be here soon, stopping in this field on their way south. Or maybe they've already been.

There are some parallel bars in the distance. You could swing from those bars, or climb that barren tree. Or you could just keep going north.

>climb barren
You climb to the top of the barren tree. The field looks distant, and small.

You are now seated in the trees. You stare at your toes, and wonder how they got there.

>climb barren tree
You are now seated in the trees. You feel a pebble beneath your buttock.

>climb barren trees
You are now seated in the trees. Life is good.

>Touch goal
You slip your fingers through the hoops of the goal's ancient net and wonder how many goals it has seen.

>taste goal
You bend down and touch your tongue to the left goal post, just above the dirt. It tastes like the roots of the World Cup.

>smell goal
Smells like phantom sweat and leather.

>listen to goal
Sounds like wild chearing on a day gone by.

>x goal
It's a soccer goal. Too bad you don't have a ball.

>kiss goal
You can only do that to something animate.

* * *

>n
Napo Field
You fly north until you can fly no more. Then you land here, in a middle school soccer field.

The air is cool and crisp to the touch. Autumn has come, and the birds will be here soon, stopping in this field on their way south. Or maybe they've already been.

There are some parallel bars in the distance. You could swing from those bars, or climb that barren tree. Or you could just keep going north.

>go north
Temple Spring
You wander north for hours, searching for you don't know what. And then you find it: A fresh spring at the temple of the nirvana fish, spouting clean, cold water from a bamboo chute.

The water flows onto a stone platform, then over the edge, and away.

>s
Kimchi Pots
Walking south you come upon some gaint Kimchi pots.

If there was kimchi in one of those pots you could eat it... you could put it in your mouth and let the spices soak your tongue.

You could climb into one of the pots and sing until your voice was hoarse.

You could stand on top of one of them and jump up and down until someone made you stop.

You could do a million things. Or nothing at all.

>s
A Stream
You run far this time, and come upon a stream where a father plays with his two daughters.

* * *

>s
Sandlot
You follow the stream, walking south, until the stream becomes a river and you can no longer touch the bottom. Then you float with your eyes closed, until the river washes you up on an asphalt shore, where two boys play baseball at dusk.

You feel your time is drawing short. You won't be able to stay here long.

>talk to boys
The boys turn and look at you. "Hello! Hello!" they shout excitedly.

>play baseball
Through pantomime you demonstrate to the boys that you are an exceptional baseball player. They gladly let you join in, and you play for some time.

>smell baseball
(the baseball players)
They probably wouldn't appreciate that.

>smell me
You smell like you just woke up from a dream.

>wait
Time passes. Or does it?

>wait
Time is short: you must leave this place.

>wait
Time is short: you must leave this place.

>look
Time is short: you must leave this place.

>n
A Group of Boys
You make your way quickly north, but a group of smiling boys jumps in front of you.

"Kimchi! My name is Bae! Hello! I love you! My name is Chin-ho!"

* * *

>n
Maisan Mountain
After traveling north for some time you find yourself atop Maisain Mountain, looking out over the farmland of North Jeolla. There's a golf course down there that you might just be able to touch, as well as some man-made lakes and Geum River, winding itself towards the Yellow Sea.

You could dance in the sky here, if you wanted. You could probably fly.

I beg your pardon?

>n
Napo Field
You fly north until you can fly no more. Then you land here, in a middle school soccer field.

The air is cool and crisp to the touch. Autumn has come, and the birds will be here soon, stopping in this field on their way south. Or maybe they've already been.

There are some parallel bars in the distance. You could swing from those bars, or climb that barren tree. Or you could just keep going north.

>drink
What do you want to drink?

* * *

>water
You can't see any such thing.

>n
Temple Spring
You wander north for hours, searching for you don't know what. And then you find it: a fresh spring at the temple of the nirvana fish, spouting clean, cold water from a bamboo shoot.

The water flows onto a stone platform, then over the edge, and away.

You can see a cup here.

* * *

>drink
(the water)
Ignoring the cups, you place your mouth to the fountain, and drink for a long moment. The water freezes your lips and chin, but it tastes like heaven.

>n
Kimchi Pots
Walking north you come upon some gaint Kimchi pots.

If there was kimchi in one of those pots you could eat it... you could put it in your mouth and let the spices soak your tongue.

You could climb into one of the pots and sing until your voice was hoarse.

You could stand on top of one of them and jump up and down until someone made you stop.

You could do a million things. Or nothing at all.

* * *

>n
A Stream
You run far this time, and come upon a stream where a father plays with his two daughters.

>drink
(the stream)
You bend down, place your head in the stream, and open your mouth. The water rushes into mouth, down your throat, and fills your stomach. Bloated, you fall over with a splash. You are now reclining in the stream.

>n
Sandlot
You follow the stream, walking north, until the stream becomes a river and you can no longer touch the bottom. Then you float with your eyes closed, until the river washes you up on an asphalt shore, where two boys play baseball at dusk.

You feel your time is drawing short. You won't be able to stay here long.

>drink
(Lake Eunpa)
Tastes fresh and earthy... no chlorine here.

>drink lake
You can't see any such thing.

>drink eunpa
You can't see any such thing.

* * *

>n
Kimchi Pots
Walking north you come upon some gaint Kimchi pots.

If there was kimchi in one of those pots you could eat it... you could put it in your mouth and let the spices soak your tongue.

You could climb into one of the pots and sing until your voice was hoarse.

You could stand on top of one of them and jump up and down until someone made you stop.

You could do a million things. Or nothing at all.

>jump on pot
You are now jumping on a closed kimchi pot. 

You jump up and down like a maniac on the ceramic lid of a kimchi pot. You better hope it doesn't break under you!

>jump
You jump on the spot. You hear rain in the distance.

* * *

>n
Kimchi Pots
Walking north you come upon some gaint Kimchi pots.

If there was kimchi in one of those pots you could eat it... you could put it in your mouth and let the spices soak your tongue.

You could climb into one of the pots and sing until your voice was hoarse.

You could stand on top of one of them and jump up and down until someone made you stop.

You could do a million things. Or nothing at all.

>jump on pot
You are now jumping on a closed kimchi pot.

>jump on pot
You are now jumping on a closed kimchi pot.

>jump on pot
You are now jumping on a closed kimchi pot. You close your eyes, but the world is still there, in front of you.

>jump on pot
You are now jumping on a closed kimchi pot. A little bug buzzes by.

>jump on pot
You are now jumping on a closed kimchi pot.

>open pot
You open a kimchi pot, revealing more kimchi than you know what to do with.

>jump on pot
You are now jumping on a closed kimchi pot.

>jump in pot
(getting off the closed kimchi pot)
You are now jumping in an open kimchi pot. The cabbage protests with belches and squeaking from under your feet.

>close pot
You close the open kimchi pot.

It is now pitch dark in here!

>eat kimchi
You'll need to open a pot first (and hope that the kimchi is actually in there).

>open pot
You open a kimchi pot, revealing more kimchi than you know what to do with.

Kimchi Pots (in the open kimchi pot)
If there was kimchi in one of those pots you could eat it... you could put it in your mouth and let the spices soak your tongue.

You could climb into one of the pots and sing until your voice was hoarse.

You could stand on top of one of them and jump up and down until someone made you stop.

You could do a million things. Or nothing at all.

In the open kimchi pot you can see a small mountain of kimchi.

>get out
You get out of the open kimchi pot.

Kimchi Pots
If there was kimchi in one of those pots you could eat it... you could put it in your mouth and let the spices soak your tongue.

You could climb into one of the pots and sing until your voice was hoarse.

You could stand on top of one of them and jump up and down until someone made you stop.

You could do a million things. Or nothing at all.

>sing in pot
You are now singing in an open kimchi pot. The cabbage resonates around you.

>l
Kimchi Pots (in the open kimchi pot)
If there was kimchi in one of those pots you could eat it... you could put it in your mouth and let the spices soak your tongue.

You could climb into one of the pots and sing until your voice was hoarse.

You could stand on top of one of them and jump up and down until someone made you stop.

You could do a million things. Or nothing at all.

In the open kimchi pot you can see a small mountain of kimchi.

* * *

>n
Maisan Mountain
After traveling north for some time you find yourself atop Maisain Mountain, looking out over the farmland of North Jeolla. There's a golf course down there that you might just be able to touch, as well as some man-made lakes and Geum River, winding itself towards the Yellow Sea.

You could dance in the sky here, if you wanted. You could probably fly.

>z
Time passes.

* * *

>n
Maisan Mountain
After traveling north for some time you find yourself atop Maisain Mountain, looking out over the farmland of North Jeolla. There's a golf course down there that you might just be able to touch, as well as some man-made lakes and Geum River, winding itself towards the Yellow Sea.

You could dance in the sky here, if you wanted. You could probably fly.

>x farm
Dark earth and rice paddies as far as the eye can see. These farms are the reason North Jeolla is known as the bread basket of Korea.

>x farm land
Dark earth and rice paddies as far as the eye can see. These farms are the reason North Jeolla is known as the bread basket of Korea.

>x farmland
Dark earth and rice paddies as far as the eye can see. These farms are the reason North Jeolla is known as the bread basket of Korea.

>smell it
Smells like wet earth and growing things.

>eat it
It tastes like mud, and rice, and insects, and food.

>z
Time passes. Or does it?

>z
Time passes.

>smell
Smells surround you...
...Cis-3-Hexenal (freshly cut grass).
...weeds and fish.
...pine needles.
...wet earth and growing things.

>listen
You hear...
...the "thwack" of clubs hitting balls, a caddy offering advice.
...the buzz of insects.
...rings expanding ever so slowly.
...insects buzzing, and green things reaching for the sky.
...birds and the wind in the trees.

>n
Napo Field
You fly north until you can fly no more. Then you land here, in a middle school soccer field.

The air is cool and crisp to the touch. Autumn has come, and the birds will be here soon, stopping in this field on their way south. Or maybe they've already been.

There are some parallel bars in the distance. You could swing from those bars, or climb that barren tree. Or you could just keep going north.

>x bars
Gymnasts use these to train and perform. You could swing from them if you wanted... you could probably even dance on them.

>climb on bars
You can't take that position on the parallel bars.

* * *

>n
Maisan Mountain
After traveling north for some time you find yourself atop Maisain Mountain, looking out over the farmland of North Jeolla. There's a golf course down there that you might just be able to touch, as well as some man-made lakes and Geum River, winding itself towards the Yellow Sea.

You could dance in the sky here, if you wanted. You could probably fly.

>stand in lake
The water's too deep.

>swim in lake
You jump into a lake. Cool water flows over you.

>sit in lake
You can't take that position in the man-made lakes.

>stand in river
The water's too deep.

* * *

>n
Maisan Mountain
After traveling north for some time you find yourself atop Maisain Mountain, looking out over the farmland of North Jeolla. There's a golf course down there that you might just be able to touch, as well as some man-made lakes and Geum River, winding itself towards the Yellow Sea.

You could dance in the sky here, if you wanted. You could probably fly.

>sit down
You are now seated. You feel a breeze behind you.

>s
(first standing up)

Blossom Street
A street stretches in front of you. You don't know this street, but it exists. Above you, and all around you, are cherry blossoms: they fill the street gutter; they overflow onto a yellow stripe of paint; they enter your nose, and come out your ears.

You see grass to the left. To the right is a yellow stripe, a streetlight, and a fence.

You could sit here if you wanted. You could run and dance on that yellow stripe. You could lie in the street and let the cherry blossoms bury you. If you wanted.

>n
Maisan Mountain
After traveling north for some time you find yourself atop Maisain Mountain, looking out over the farmland of North Jeolla. There's a golf course down there that you might just be able to touch, as well some man-made lakes and Geum River, winding itself towards the Yellow Sea.

You could dance in the sky here, if you wanted. You could probably fly.

>s
Blossom Street
A street stretches in front of you. You don't know this street, but it exists. Above you, and all around you, are cherry blossoms: they fill the street gutter; they overflow onto a yellow stripe of paint; they enter your nose, and come out your ears.

You see grass to the left. To the right is a yellow stripe, a streetlight, and a fence.

You could sit here if you wanted. You could run and dance on that yellow stripe. You could lie in the street and let the cherry blossoms bury you. If you wanted.

* * *

>n
Maisan Mountain
After traveling north for some time you find yourself atop Maisain Mountain, looking out over the farmland of North Jeolla. There's a golf course down there that you might just be able to touch, as well as some man-made lakes and Geum River, winding itself towards the Yellow Sea.

You could dance in the sky here, if you wanted. You could probably fly.

>s
Napo Field
You fly south until you can fly no more. Then you land here, in a middle school soccer field.

The air is cool and crisp to the touch. Autumn has come, and the birds will be here soon, stopping in this field on their way south. Or maybe they've already been.

There are some parallel bars in the distance. You could swing from those bars, or climb that barren tree. Or you could just keep going south.

* * *

>n
Maisan Mountain
After traveling north for some time you find yourself atop Maisain Mountain, looking out over the farmland of North Jeolla. There's a golf course down there that you might just be able to touch, as well as some man-made lakes and Geum River, winding itself towards the Yellow Sea.

You could dance in the sky here, if you wanted. You could probably fly.

>l
Maisan Mountain
Maisain Mountain, looking out over the farmland of North Jeolla. There's a golf course down there that you might just be able to touch, as well some man-made lakes and Geum River, winding itself towards the Yellow Sea.

You could dance in the sky here, if you wanted. You could probably fly.

>fly in sky
You are now flying in the sky. You feel millions of Nitrogen and Oxygen particles hitting your skin.

>l
Maisan Mountain (in the sky)
Maisain Mountain, looking out over the farmland of North Jeolla. There's a golf course down there that you might just be able to touch, as well some man-made lakes and Geum River, winding itself towards the Yellow Sea.

You could dance in the sky here, if you wanted. You could probably fly.

>get down
You get out of the sky.

Maisan Mountain
Maisain Mountain, looking out over the farmland of North Jeolla. There's a golf course down there that you might just be able to touch, as well some man-made lakes and Geum River, winding itself towards the Yellow Sea.

You could dance in the sky here, if you wanted. You could probably fly.

* * *

>n
Maisan Mountain
After traveling north for some time you find yourself atop Maisain Mountain, looking out over the farmland of North Jeolla. There's a golf course down there that you might just be able to touch, as well as some man-made lakes and Geum River, winding itself towards the Yellow Sea.

You could dance in the sky here, if you wanted. You could probably fly.

>dance
You are now dancing. Your best imitation of a European folk dance. Where'd you get the clogs?

>n
(first standing up)

Napo Field
You fly north until you can fly no more. Then you land here, in a middle school soccer field.

The air is cool and crisp to the touch. Autumn has come, and the birds will be here soon, stopping in this field on their way south. Or maybe they've already been.

There are some parallel bars in the distance. You could swing from those bars, or climb that barren tree. Or you could just keep going north.

>n
Temple Spring
You wander north for hours, searching for you don't know what. And then you find it: A fresh spring at the temple of the nirvana fish, spouting clean, cold water from a bamboo chute.

The water flows onto a stone platform, then over the edge, and away.

* * *

>n
A Pavilion
You manage to break away from the group of boys. Running now, panting, you've hardly any time left. Glancing to your right, you see a man helping a young boy take off his shoes before entering a pavilion.

>n
Leaving
You're flying now, faster than you've ever flown before... the air that streams by you feels like a thick liquid. Glancing over your shoulder, your last glimpse of Korea is a girl in red stripes, holding an umbrella.

And then she's gone.

>[enter]
Being There. A notgame for Korea, created by Jordan Magnuson.

                                       NecessaryGames.com

* * *

>dance
You are now dancing. Your best imitation of a European folk dance. Where'd you get the clogs?

>dance
You dancing some more.

>dance
You dancing some more.

* * *

>n
Maisan Mountain
After traveling north for some time you find yourself atop Maisain Mountain, looking out over the farmland of North Jeolla. There's a golf course down there that you might just be able to touch, as well as some man-made lakes and Geum River, winding itself towards the Yellow Sea.

You could dance in the sky here, if you wanted. You could probably fly.

>play
Why not? You grab a stick and play a round of golf, using it as a club.

* * *

>n
Maisan Mountain
After traveling north for some time you find yourself atop Maisain Mountain, looking out over the farmland of North Jeolla. There's a golf course down there that you might just be able to touch, as well as some man-made lakes and Geum River, winding itself towards the Yellow Sea.

You could dance in the sky here, if you wanted. You could probably fly.

>swim
What do you want to swim in?

>river
You dive into the river and swim its full breadth, then lie back and have a float.

>l
Maisan Mountain (in Geum River)
Maisain Mountain, looking out over the farmland of North Jeolla. There's a golf course down there that you might just be able to touch, as well as some man-made lakes and Geum River, winding itself towards the Yellow Sea.

You could dance in the sky here, if you wanted. You could probably fly.

>play golf
You get out of Geum River.

Maisan Mountain
Maisain Mountain, looking out over the farmland of North Jeolla. There's a golf course down there that you might just be able to touch, as well as some man-made lakes and Geum River, winding itself towards the Yellow Sea.

You could dance in the sky here, if you wanted. You could probably fly.

Why not? You grab a stick and play a round of golf, using it as a club.

>l
Maisan Mountain
Maisain Mountain, looking out over the farmland of North Jeolla. There's a golf course down there that you might just be able to touch, as well as some man-made lakes and Geum River, winding itself towards the Yellow Sea.

You could dance in the sky here, if you wanted. You could probably fly.

* * *

>n
Maisan Mountain
After traveling north for some time you find yourself atop Maisain Mountain, looking out over the farmland of North Jeolla. There's a golf course down there that you might just be able to touch, as well as some man-made lakes and Geum River, winding itself towards the Yellow Sea.

You could dance in the sky here, if you wanted. You could probably fly.

>go north
Napo Field
You fly north until you can fly no more. Then you land here, in a middle school soccer field.

The air is cool and crisp to the touch. Autumn has come, and the birds will be here soon, stopping in this field on their way south. Or maybe they've already been.

There are some parallel bars in the distance. You could swing from those bars, or climb that barren tree. Or you could just keep going north.

>go south
Temple Spring
You wander south for hours, searching for you don't know what. And then you find it: A fresh spring at the temple of the nirvana fish, spouting clean, cold water from a bamboo chute.

The water flows onto a stone platform, then over the edge, and away.

>hit water
Violence isn't the answer to this one.

* * *

>n
Maisan Mountain
After traveling north for some time you find yourself atop Maisain Mountain, looking out over the farmland of North Jeolla. There's a golf course down there that you might just be able to touch, as well as some man-made lakes and Geum River, winding itself towards the Yellow Sea.

You could dance in the sky here, if you wanted. You could probably fly.

>x grass
You see nothing special about the golf course.

>touch grass
You stretch out a hand, and can just feel the the crisp smooth grass of a green under your fingers.

>smell grass
Smells like Cis-3-Hexenal (freshly cut grass).

>swim in river
You dive into the river and swim its full breadth, then lie back and have a float.

>swim
(in Geum River)
You swim around some more.

>swim in lake
(getting out of Geum River)
You jump into a lake. Cool water flows over you.

>swim
(in the man-made lakes)
You swim around some more.

>swim
(in the man-made lakes)
You swim around some more.

>swim in river
(getting out of the man-made lakes)
You dive into the river and swim its full breadth, then lie back and have a float.

>swim
(in Geum River)
You swim around some more.

>dive
You plunge deep into the water, surrounding yourself with the cool liquid until you can hold your breath no more, then you surface again.

>dance in the river
You are now dancing in Geum River. Twirling ballet style.

>lie in the river
You are now reclining in Geum River. Arms outstretched.

* * *

>n
Maisan Mountain
After traveling north for some time you find yourself atop Maisain Mountain, looking out over the farmland of North Jeolla. There's a golf course down there that you might just be able to touch, as well as some man-made lakes and Geum River, winding itself towards the Yellow Sea.

You could dance in the sky here, if you wanted. You could probably fly.

>dance in the lake
You are now dancing in the man-made lakes. Sort of a solo waltz.

>sit in lake
You are now seated in the man-made lakes. Legs out in front of you.

* * *

>n
Maisan Mountain
After traveling north for some time you find yourself atop Maisain Mountain, looking out over the farmland of North Jeolla. There's a golf course down there that you might just be able to touch, as well as some man-made lakes and Geum River, winding itself towards the Yellow Sea.

You could dance in the sky here, if you wanted. You could probably fly.

>dance in lake
you are in waterYou are now dancing in the man-made lakes. The breeze ruffles your hair.

* * *

>n
Maisan Mountain
After traveling north for some time you find yourself atop Maisain Mountain, looking out over the farmland of North Jeolla. There's a golf course down there that you might just be able to touch, as well as some man-made lakes and Geum River, winding itself towards the Yellow Sea.

You could dance in the sky here, if you wanted. You could probably fly.

>dance in water
Which do you mean, the man-made lakes or Geum River?

>lake
You spin and you spin, until you can't see straight.

>sit in lake
You feel a pebble beneath your buttock.

>sing in lake
Tiny drums in your ears vibrate in time.

>stand in lake
You try to stand on the water, Jesus-style. You fail, sink, then float to the top.

>stand in lake
You try to stand on the water, Jesus-style. You fail, sink, then float to the top.

>stand in river
The water's too deep.

>stand in lake
You try to stand on the water, Jesus-style. You fail, sink, then float to the top.

>l
Maisan Mountain (in the man-made lakes)
Maisain Mountain, looking out over the farmland of North Jeolla. There's a golf course down there that you might just be able to touch, as well as some man-made lakes and Geum River, winding itself towards the Yellow Sea.

You could dance in the sky here, if you wanted. You could probably fly.

>stand on ground
(getting out of the man-made lakes)
You are now standing on the ground. It feels firm beneath your feet.

>stand in lake
(getting out of the ground)
You try to stand on the water, Jesus-style. You fail, sink, then float to the top.

>l
Maisan Mountain (in the man-made lakes)
Maisain Mountain, looking out over the farmland of North Jeolla. There's a golf course down there that you might just be able to touch, as well as some man-made lakes and Geum River, winding itself towards the Yellow Sea.

You could dance in the sky here, if you wanted. You could probably fly.

* * *

>n
Maisan Mountain
After traveling north for some time you find yourself atop Maisain Mountain, looking out over the farmland of North Jeolla. There's a golf course down there that you might just be able to touch, as well as some man-made lakes and Geum River, winding itself towards the Yellow Sea.

You could dance in the sky here, if you wanted. You could probably fly.

>run on lake
You run as fast as you can and make it several feet across the water's surface before sinking. Fancy people call this "liquid mountaineering." Life is good.

>run
You are already running.

>l
Maisan Mountain (in the man-made lakes)
Maisain Mountain, looking out over the farmland of North Jeolla. There's a golf course down there that you might just be able to touch, as well as some man-made lakes and Geum River, winding itself towards the Yellow Sea.

You could dance in the sky here, if you wanted. You could probably fly.

>run on river
(getting out of the man-made lakes)
You run as fast as you can and make it several feet across the water's surface before sinking. Fancy people call this "liquid mountaineering."

>run in river
You run as fast as you can and make it several feet across the water's surface before sinking. Fancy people call this "liquid mountaineering."

>sit on river
You sit in a shallow part of the water.

>dance
You thrash about in the water, attempting a new kind of aquatic ballet. The earth spins slowly.

>recline
That's not a verb I recognize.

>lie in lake
(getting out of Geum River)
You throw your arms back and lie in the water, floating as best you can. The breeze ruffles your hair.

>swim
(in the man-made lakes)
You swim around some more.

* * *

>swim
(in Geum River)
You swim around some more.

>swing in river
You can't really swing on that.

>l
Maisan Mountain (in Geum River)
Maisain Mountain, looking out over the farmland of North Jeolla. There's a golf course down there that you might just be able to touch, as well as some man-made lakes and Geum River, winding itself towards the Yellow Sea.

You could dance in the sky here, if you wanted. You could probably fly.

>breathe
You breathe in deeply... and get a lung full of water. A few coughs and splutters later and you're almost as good as new. Just like when you were a kid.

* * *

>n
Maisan Mountain
After traveling north for some time you find yourself atop Maisain Mountain, looking out over the farmland of North Jeolla. There's a golf course down there that you might just be able to touch, as well as some man-made lakes and Geum River, winding itself towards the Yellow Sea.

You could dance in the sky here, if you wanted. You could probably fly.

>wait
Time passes. Or does it?

>wait
Time passes. You feel a breeze behind you.

>wait
Time passes.

>wait
Time passes. You hear thunder rumble in a distant land.

>wait
Time passes.

>wait
Time passes. Life is good.

>wait
Time passes. You close your eyes, but the world is still there, in front of you.

>wait
Time passes.

>wait
Time stands still.

>wait
Time passes. A beam of sunlight crosses in front of you.

>wait
Time passes. Something around you smells... interesting.

>wait
Time passes.

>wait
Time passes.

>wait
Time passes. You hear rain in the distance.

>wait
Time passes. You close your eyes for a moment... and almost fall asleep.

>wait
Time passes. Just like when you were a kid... or maybe not.

>wait
Time passes. A bird flies by, and looks at you.

>wait
Time passes. You take a deep breath.

>wait
Time passes. The ether shifts around you.

>wait
Time passes.

* * *

Blossom Street
A street stretches in front of you. You don't know this street, but it exists. Above you, and all around you, are cherry blossoms: they fill the street gutter; they overflow onto a yellow stripe of paint; they enter your nose, and come out your ears.

You see grass to the left. To the right is a yellow stripe, a streetlight, and a fence.

You could sit here if you wanted. You could run and dance on that yellow stripe. You could lie in the street and let the cherry blossoms bury you. If you wanted.

>drink road
There's nothing suitable to drink here.

>n
Maisan Mountain
After traveling north for some time you find yourself atop Maisain Mountain, looking out over the farmland of North Jeolla. There's a golf course down there that you might just be able to touch, as well some man-made lakes and Geum River, winding itself towards the Yellow Sea.

You could dance in the sky here, if you wanted. You could probably fly.

* * *

>drink
(Lake Eunpa)
You can't reach into Maisan Mountain.

>showme lake eunpa
Lake Eunpa - spot
location: in Sandlot
unlit; inedible; fixed in place; scenery; singular-named; proper-named; neuter; ordinarily enumerated; seen; unfamiliar; unswingable; not-one-of-many; drinkable; weak_smelling; soft_sounding
description: A man-made resevoir built by the Japanese that now serves as a beautiful lake, surrounded by walkways.
printed name: Lake Eunpa
printed plural name: spots
feeling: You put a toe into the lake... a fish gives it a nible.
flavor: Tastes fresh and earthy... no chlorine here.
odor: weeds and fish
sound: the buzz of insects
enterable
carrying capacity: 100
posture: standing

>drink eunpa
You can't reach into Maisan Mountain.

* * *

Blossom Street
A street stretches in front of you. You don't know this street, but it exists. Above you, and all around you, are cherry blossoms: they fill the street gutter; they overflow onto a yellow stripe of paint; they enter your nose, and come out your ears.

You see grass to the left. To the right is a yellow stripe, a streetlight, and a fence.

You could sit here if you wanted. You could run and dance on that yellow stripe. You could lie in the street and let the cherry blossoms bury you. If you wanted.

>x other side
You can't see any such thing.

>x the other side
You can't see any such thing.

>x construction
Looks to be a convention center of some sort, or a hotel. You can see the hole where the pool will be.

>x the other side
You can't see any such thing.

* * *

>x construction
Looks to be a convention center of some sort, or a hotel. You can see the hole where the pool will be.

>jump on stripe
I only understood the first part of that-- trying anyway.

(retrying as if you'd typed "jump.")
You jump on the spot. You feel a breeze behind you.

* * *

>x other side
You can't see any such thing.

>x other-side
Looks to be a convention center of some sort, or a hotel. You can see the hole where the pool will be.

>x the other side
You can't see any such thing.

* * *

Blossom Street
A street stretches in front of you. You don't know this street, but it exists. Above you, and all around you, are cherry blossoms: they fill the street gutter; they overflow onto a yellow stripe of paint; they enter your nose, and come out your ears.

You see grass to the left. To the right is a yellow stripe, a streetlight, and a fence.

You could sit here if you wanted. You could run and dance on that yellow stripe. You could lie in the street and let the cherry blossoms bury you. If you wanted.

>look over fence
Looks to be a convention center of some sort, or a hotel. You can see the hole where the pool will be.

>peer over fence
Looks to be a convention center of some sort, or a hotel. You can see the hole where the pool will be.

* * *

Blossom Street
A street stretches in front of you. You don't know this street, but it exists. Above you, and all around you, are cherry blossoms: they fill the street gutter; they overflow onto a yellow stripe of paint; they enter your nose, and come out your ears.

You see grass to the left. To the right is a yellow stripe, a streetlight, and a fence.

You could sit here if you wanted. You could run and dance on that yellow stripe. You could lie in the street and let the cherry blossoms bury you. If you wanted.

>look through fence
You find nothing of interest.

>look through fence
You find nothing of interest.

>look at fence
It's a construction fence, with mountains on it. Someone's building something on the far side.

>look over fence
Looks to be a convention center of some sort, or a hotel. You can see the hole where the pool will be.

* * *

Blossom Street
A street stretches in front of you. You don't know this street, but it exists. Above you, and all around you, are cherry blossoms: they fill the street gutter; they overflow onto a yellow stripe of paint; they enter your nose, and come out your ears.

You see grass to the left. To the right is a yellow stripe, a streetlight, and a fence.

You could sit here if you wanted. You could run and dance on that yellow stripe. You could lie in the street and let the cherry blossoms bury you. If you wanted.

>climb streetlight
*** Run-time problem P7: Too many rulebooks in simultaneous use.

You shimmy up the pole "till you get to the lamp, and can go no higher. You get a nice view of the construction on the other side of the fence from here.
You shimmy up the pole "till you get to the lamp, and can go no higher. You get a nice view of the construction on the other side of the fence from here.
You shimmy up the pole "till you get to the lamp, and can go no higher. You get a nice view of the construction on the other side of the fence from here.
You shimmy up the pole "till you get to the lamp, and can go no higher. You get a nice view of the construction on the other side of the fence from here.
You shimmy up the pole "till you get to the lamp, and can go no higher. You get a nice view of the construction on the other side of the fence from here.
You shimmy up the pole "till you get to the lamp, and can go no higher. You get a nice view of the construction on the other side of the fence from here.
You shimmy up the pole "till you get to the lamp, and can go no higher. You get a nice view of the construction on the other side of the fence from here.
You shimmy up the pole "till you get to the lamp, and can go no higher. You get a nice view of the construction on the other side of the fence from here.
You shimmy up the pole "till you get to the lamp, and can go no higher. You get a nice view of the construction on the other side of the fence from here.

* * *

Blossom Street
A street stretches in front of you. You don't know this street, but it exists. Above you, and all around you, are cherry blossoms: they fill the street gutter; they overflow onto a yellow stripe of paint; they enter your nose, and come out your ears.

You see grass to the left. To the right is a yellow stripe, a streetlight, and a fence.

You could sit here if you wanted. You could run and dance on that yellow stripe. You could lie in the street and let the cherry blossoms bury you. If you wanted.

>climb light
That's not something you can enter.
You shimmy up the pole 'till you get to the lamp, and can go no higher. A bug peers out at you from behind the plastic.

>sleep
You shut your eyes, and doze off... for how long, you don't know, and you don't care.

>doze
You shut your eyes, and doze off... for how long, you don't know, and you don't care.

>nap
You shut your eyes, and doze off... for how long, you don't know, and you don't care.

>take nap
You shut your eyes, and doze off... for how long, you don't know, and you don't care.

>take a nap
You can't see any such thing.

* * *

>climb light
That's not something you can enter.
You shimmy up the pole 'till you get to the lamp, and can go no higher. A bug peers out at you from behind the plastic.

>l
Blossom Street (on the streetlight)
A street stretches in front of you. You don't know this street, but it exists. Above you, and all around you, are cherry blossoms: they fill the street gutter; they overflow onto a yellow stripe of paint; they enter your nose, and come out your ears.

You see grass to the left. To the right is a yellow stripe, a streetlight, and a fence.

You could sit here if you wanted. You could run and dance on that yellow stripe. You could lie in the street and let the cherry blossoms bury you. If you wanted.

>d
You are not on anything.

>climb fence
You can't take that position on the fence.

>l
Blossom Street (on the fence)
A street stretches in front of you. You don't know this street, but it exists. Above you, and all around you, are cherry blossoms: they fill the street gutter; they overflow onto a yellow stripe of paint; they enter your nose, and come out your ears.

You see grass to the left. To the right is a yellow stripe, a streetlight, and a fence.

You could sit here if you wanted. You could run and dance on that yellow stripe. You could lie in the street and let the cherry blossoms bury you. If you wanted.

* * *

>l
Blossom Street (on the streetlight)
A street stretches in front of you. You don't know this street, but it exists. Above you, and all around you, are cherry blossoms: they fill the street gutter; they overflow onto a yellow stripe of paint; they enter your nose, and come out your ears.

You see grass to the left. To the right is a yellow stripe, a streetlight, and a fence.

You could sit here if you wanted. You could run and dance on that yellow stripe. You could lie in the street and let the cherry blossoms bury you. If you wanted.

>l
Blossom Street (on the streetlight)
A street stretches in front of you. You don't know this street, but it exists. Above you, and all around you, are cherry blossoms: they fill the street gutter; they overflow onto a yellow stripe of paint; they enter your nose, and come out your ears.

You see grass to the left. To the right is a yellow stripe, a streetlight, and a fence.

You could sit here if you wanted. You could run and dance on that yellow stripe. You could lie in the street and let the cherry blossoms bury you. If you wanted.

>climb light
You've gone as far as you can up the pole.

>d
You let yourself back down to the ground.

>climb light
You shimmy up the pole 'till you get to the lamp, and can go no higher.

>climb light
You've gone as far as you can up the pole.

>climb light
You've gone as far as you can up the pole.

>sit on light
You can't take that position on the streetlight.

>dance on light
You can't take that position on the streetlight.

>climb light
You've gone as far as you can up the pole.

* * *

>sit on light
You can't take that position on the streetlight.

>sing on light
You can't take that position on the streetlight.

* * *

Blossom Street
A street stretches in front of you. You don't know this street, but it exists. Above you, and all around you, are cherry blossoms: they fill the street gutter; they overflow onto a yellow stripe of paint; they enter your nose, and come out your ears.

You see grass to the left. To the right is a yellow stripe, a streetlight, and a fence.

You could sit here if you wanted. You could run and dance on that yellow stripe. You could lie in the street and let the cherry blossoms bury you. If you wanted.

>jump on road
You can't take that position on the road.

>jump on stripe
(getting off the road)
You are now jumping on the yellow stripe of paint.

>jump
You jump on the spot. You feel a breeze behind you.

>l
Blossom Street (on the yellow stripe of paint)
A street stretches in front of you. You don't know this street, but it exists. Above you, and all around you, are cherry blossoms: they fill the street gutter; they overflow onto a yellow stripe of paint; they enter your nose, and come out your ears.

You see grass to the left. To the right is a yellow stripe, a streetlight, and a fence.

You could sit here if you wanted. You could run and dance on that yellow stripe. You could lie in the street and let the cherry blossoms bury you. If you wanted.

>sit on road
(getting off the yellow stripe of paint)
You are now seated on the road. You feel a pebble beneath your buttock.

>l
Blossom Street (on the road)
A street stretches in front of you. You don't know this street, but it exists. Above you, and all around you, are cherry blossoms: they fill the street gutter; they overflow onto a yellow stripe of paint; they enter your nose, and come out your ears.

You see grass to the left. To the right is a yellow stripe, a streetlight, and a fence.

You could sit here if you wanted. You could run and dance on that yellow stripe. You could lie in the street and let the cherry blossoms bury you. If you wanted.

* * *

Blossom Street
A street stretches in front of you. You don't know this street, but it exists. Above you, and all around you, are cherry blossoms: they fill the street gutter; they overflow onto a yellow stripe of paint; they enter your nose, and come out your ears.

You see grass to the left. To the right is a yellow stripe, a streetlight, and a fence.

You could sit here if you wanted. You could run and dance on that yellow stripe. You could lie in the street and let the cherry blossoms bury you. If you wanted.

>climb tree
You grab a branch and swing yourself up, into the midst of the blossoms. Kind of like being in a snowglobe.

You are now seated in the cherry blossom trees. You rest your chin on your upraised knees.

>l
Blossom Street (on the cherry blossom trees)
A street stretches in front of you. You don't know this street, but it exists. Above you, and all around you, are cherry blossoms: they fill the street gutter; they overflow onto a yellow stripe of paint; they enter your nose, and come out your ears.

You see grass to the left. To the right is a yellow stripe, a streetlight, and a fence.

You could sit here if you wanted. You could run and dance on that yellow stripe. You could lie in the street and let the cherry blossoms bury you. If you wanted.

>sit on grass
You are now seated on the grass. You feel a pebble beneath your buttock.

>l
Blossom Street (on the grass)
A street stretches in front of you. You don't know this street, but it exists. Above you, and all around you, are cherry blossoms: they fill the street gutter; they overflow onto a yellow stripe of paint; they enter your nose, and come out your ears.

You see grass to the left. To the right is a yellow stripe, a streetlight, and a fence.

You could sit here if you wanted. You could run and dance on that yellow stripe. You could lie in the street and let the cherry blossoms bury you. If you wanted.

>climb tree
You grab a branch and swing yourself up, into the midst of the blossoms. Kind of like being in a snowglobe.

>l
Blossom Street (on the grass)
A street stretches in front of you. You don't know this street, but it exists. Above you, and all around you, are cherry blossoms: they fill the street gutter; they overflow onto a yellow stripe of paint; they enter your nose, and come out your ears.

You see grass to the left. To the right is a yellow stripe, a streetlight, and a fence.

You could sit here if you wanted. You could run and dance on that yellow stripe. You could lie in the street and let the cherry blossoms bury you. If you wanted.

>sit in tree
(getting off the grass)
You are now seated on the cherry blossom trees. Cross-legged.

>sit in road
(getting out of the cherry blossom trees)
You are now seated on the road. Legs out in front of you.

>sit in gutter
(getting off the road)
You are now seated on the gutter. You rest your chin on your upraised knees.

* * *

>l
Blossom Street (on the cherry blossom trees)
A street stretches in front of you. You don't know this street, but it exists. Above you, and all around you, are cherry blossoms: they fill the street gutter; they overflow onto a yellow stripe of paint; they enter your nose, and come out your ears.

You see grass to the left. To the right is a yellow stripe, a streetlight, and a fence.

You could sit here if you wanted. You could run and dance on that yellow stripe. You could lie in the street and let the cherry blossoms bury you. If you wanted.

>climb on tree
You are now climbing on the cherry blossom trees.

* * *

>l
Blossom Street (on the cherry blossom trees)
A street stretches in front of you. You don't know this street, but it exists. Above you, and all around you, are cherry blossoms: they fill the street gutter; they overflow onto a yellow stripe of paint; they enter your nose, and come out your ears.

You see grass to the left. To the right is a yellow stripe, a streetlight, and a fence.

You could sit here if you wanted. You could run and dance on that yellow stripe. You could lie in the street and let the cherry blossoms bury you. If you wanted.

>d
You let yourself back down to the ground.

>d
You are not on anything.

>d
You are not on anything.

>climb tree
You are now climbing on the cherry blossom trees.

>d
You let yourself back down to the ground.

>l
Blossom Street
A street stretches in front of you. You don't know this street, but it exists. Above you, and all around you, are cherry blossoms: they fill the street gutter; they overflow onto a yellow stripe of paint; they enter your nose, and come out your ears.

You see grass to the left. To the right is a yellow stripe, a streetlight, and a fence.

You could sit here if you wanted. You could run and dance on that yellow stripe. You could lie in the street and let the cherry blossoms bury you. If you wanted.

>climb trees
You are now climbing on the cherry blossom trees.

>down
You let yourself back down to the ground.

>sit on road
You are now seated on the road. You feel a pebble beneath your buttock.

>d
You let yourself back down to the ground.

* * *

>d
You are not on anything.

>sit on road
You are now seated on the road. Cross-legged.

>d
You let yourself back down to the ground.

* * *

>d
You are not on anything.

>down
You are not on anything.

>get down
You must name something more substantial.

>climb tree
You are now climbing on the cherry blossom trees.

>get down
You must name something more substantial.

>jump on road
(getting off the cherry blossom trees)
You are now jumping on the road.

>jump
You jump on the spot. Life is good.

>stop
You stop what you're doing.

>play soccer
You play soccer with an invisible ball... you score!

>sing in tree
(getting off the road)
You are now singing on the cherry blossom trees. You belt it out like a good one.

>climb tee
You can't see any such thing.

>l
Blossom Street (on the cherry blossom trees)
A street stretches in front of you. You don't know this street, but it exists. Above you, and all around you, are cherry blossoms: they fill the street gutter; they overflow onto a yellow stripe of paint; they enter your nose, and come out your ears.

You see grass to the left. To the right is a yellow stripe, a streetlight, and a fence.

You could sit here if you wanted. You could run and dance on that yellow stripe. You could lie in the street and let the cherry blossoms bury you. If you wanted.

>go down
You let yourself back down to the ground.

* * *

>climb tree
You grab a branch and swing yourself up, into the midst of the blossoms. Kind of like being in a snowglobe.

You are now seated in the cherry blossom trees. You rest your chin on your upraised knees.

>climb in tree
You are now climbing on the cherry blossom trees.

>climb tree
I don't think much is to be achieved by that.

>smell me
You smell like you just woke up from a dream.

>smell
Smells surround you...
...paint and asphalt mixed with cherry blossoms.
...the grassy green odor you know so well from all the time you've spent lying in it.
...earthworms and rubber.
...perfume.
...something sweet and dewy.
...something sweet and dewy, mixed with bark.

>smell perfume
You can't see any such thing.

>smell me
You smell like you just woke up from a dream.

>touch me
You feel like something alive.

>eat me
A bit of salt, a bit of skin. You're human after all.

>x mountains
It's a construction fence, with mountains on it. Someone's building something on the far side.

>x fence
It's a construction fence, with mountains on it. Someone's building something on the far side.

>n
(first leaving the cherry blossom trees)

Maisan Mountain
After traveling north for some time you find yourself atop Maisain Mountain, looking out over the farmland of North Jeolla. There's a golf course down there that you might just be able to touch, as well some man-made lakes and Geum River, winding itself towards the Yellow Sea.

You could dance in the sky here, if you wanted. You could probably fly.

>smell
Smells surround you...
...Cis-3-Hexenal... freshly cut grass.
...weeds and fish.
...pine needles.

>n
Napo Field
You fly north until you can fly no more. Then you land here, in a middle school soccer field.

The air is cool and crisp to the touch. Autumn has come, and the birds will be here soon, stopping in this field on their way south. Or maybe they've already been.

There are some parallel bars in the distance. You could swing from those bars, or climb that barren tree. Or yoo could just keep going north.

>x grass
Most Korean soccer fields are worn to dirt. This one is surprisingly well-carpeted.

>x soccer
Which do you mean, the middle school soccer field, or the soccer goal?

>goal
It's a soccer goal. Too bad you don't have a ball.

>play soccer
You play soccer with an invisible ball.

>n
Temple Spring
You wander north for hours, searching for you don't know what. And then you find it: a fresh spring at the temple of the nirvana fish, spouting clean, cold water from a bamboo shoot.

The water flows onto a stone platform, then over the edge, and away.

You can see a cup here.

* * *

>x pot
Large pots made for holding Korea's favorite food. Big enough to climb into... or stand on.

>eat kimchi
You'll need to open a pot first.

>open pot
You open a kimchi pot, revealing more kimchi than you know what to do with.

>sit in pot
You are now sitting in an open kimchi pot; the strong spicy odor surrounds you, and the cabbage is soft beneath you.

>sit on pot
You are now sitting on one of the closed kimchi pots. You feel the power of kimchi beneath you.

* * *

>stand in pot
You are now standing in an open kimchi pot; the strong spicy odor surrounds you, and the cabbage is soft beneath your bare feet.

>stand on pot
You are now standing on a closed kimchi pot. You feel tall.

>get in pot
(getting off the closed kimchi pot)
You get into the open kimchi pot.

In the open kimchi pot you can see a small mountain of kimchi.

>sing
You are now singing on an open kimchi pot. You feel a breeze behind you.

>n
(first leaving the open kimchi pot)

A Stream
You run far this time, and come upon a stream where a father plays with his two daughters.

>x daughter
You can't see any such thing.

>sit in stream
You are now seated on the stream. You feel a pebble beneath your buttock.

>w
You'll have to get out of the stream first.

>out
You get out of the stream.

A Stream
You run far this time, and come upon a stream where a father plays with his two daughters.

>w
Sandlot
You follow the stream, walking west, until the stream becomes a river and you can no longer touch the bottom. Then you float with your eyes closed, until the river washes you up on an asphalt shore, where two boys play baseball at dusk.

You feel your time is drawing short. You won't be able to stay here long.

>l
Sandlot
You follow the stream, walking west, until the stream becomes a river and you can no longer touch the bottom. Then you float with your eyes closed, until the river washes you up on an asphalt shore, where two boys play baseball at dusk.

You feel your time is drawing short. You won't be able to stay here long.

I beg your pardon?

>z
The cherry blossoms pile higher.

* * *

>z
The cherry blossoms pile higher still.

>z
Time is short: you must leave this place.

>w
A Group of Boys
You make your way qucikly west, but a group of smiling boys jumps in front of you.

"Kimchi! My name is Bae! Hello! I love you! My name is Chin-ho!"

>talk to boys
"Annyeonghaseyo!" yell the boys in unison. One of them is jumping uncontrollably.

>say hello
There is no more time to spare: you must keep moving.

>fly
There is no more time to spare: you must keep moving.

>leave
There is no time to stop now.

>leave
Leaving
You're flying now, faster than you've ever flown before... the air that streams by you feels like a thick liquid. Glancing over your shoulder, your last glimpse of Korea is a girl in red stripes, holding an umbrella.

And then she's gone.

Being There. A notgame for Korea, created by Jordan Magnuson.

* * *

>climb tree
You grab a branch and swing yourself up, into the midst of the blossoms. Kind of like being in a snowglobe.

You are now seated in the cherry blossom trees. You rest your chin on your upraised knees.

>down
Maisan Mountain
After traveling down for some time you find yourself atop Maisain Mountain, looking out over the farmland of North Jeolla. There's a golf course down there that you might just be able to touch, as well some man-made lakes and Geum River, winding itself towards the Yellow Sea.

You could dance in the sky here, if you wanted. You could probably fly.

>up
Napo Field
You fly up until you can fly no more. Then you land here, in a middle school soccer field.

The air is cool and crisp to the touch. Autumn has come, and the birds will be here soon, stopping in this field on their way south. Or maybe they've already been.

There are some parallel bars in the distance. You could swing from those bars, or climb that barren tree. Or you could just keep going up.

>go up
Temple Spring
You wander up for hours, searching for you don't know what. And then you find it: a fresh spring at the temple of the nirvana fish, spouting clean, cold water from a bamboo chute.

The water flows onto a stone platform, then over the edge, and away.

You can see a cup here.

* * *

>climb tree
You grab a branch and swing yourself up, into the midst of the blossoms. Kind of like being in a snowglobe.

You are now seated in the cherry blossom trees. You rest your chin on your upraised knees.

>sit on tree
You are now seated on the cherry blossom trees. You feel a pebble beneath your buttock.

>l
Blossom Street (on the cherry blossom trees)
A street stretches in front of you. You don't know this street, but it exists. Above you, and all around you, are cherry blossoms: they fill the street gutter; they overflow onto a yellow stripe of paint; they enter your nose, and come out your ears.

You see grass to the left. To the right is a yellow stripe, a streetlight, and a fence.

You could sit here if you wanted. You could run and dance on that yellow stripe. You could lie in the street and let the cherry blossoms bury you. If you wanted.

>d
You sit down, on the ground.

>sit on tree
You are now seated on the cherry blossom trees. Cross-legged.

>exit
You get off the cherry blossom trees.

Blossom Street
A street stretches in front of you. You don't know this street, but it exists. Above you, and all around you, are cherry blossoms: they fill the street gutter; they overflow onto a yellow stripe of paint; they enter your nose, and come out your ears.

You see grass to the left. To the right is a yellow stripe, a streetlight, and a fence.

You could sit here if you wanted. You could run and dance on that yellow stripe. You could lie in the street and let the cherry blossoms bury you. If you wanted.

* * *

>climb tree
You grab a branch and swing yourself up, into the midst of the blossoms. Kind of like being in a snowglobe.

You are now seated in the cherry blossom trees. You rest your chin on your upraised knees.

>climb
You are already climbing.

>get down
You get off the cherry blossom trees.

Blossom Street
A street stretches in front of you. You don't know this street, but it exists. Above you, and all around you, are cherry blossoms: they fill the street gutter; they overflow onto a yellow stripe of paint; they enter your nose, and come out your ears.

You see grass to the left. To the right is a yellow stripe, a streetlight, and a fence.

You could sit here if you wanted. You could run and dance on that yellow stripe. You could lie in the street and let the cherry blossoms bury you. If you wanted.

>get down
But you aren't in anything at the moment.

>up
You can't go that way.

>up
You can't go that way.

>climb tree
You are now climbing on the cherry blossom trees.

>climb on tree
You are now climbing on the cherry blossom trees.

>climb tree
You are now climbing on the cherry blossom trees. You feel a breeze behind you.

* * *

>climb tree
You grab a branch and swing yourself up, into the midst of the blossoms. Kind of like being in a snowglobe.

You are now seated in the cherry blossom trees. You rest your chin on your upraised knees.

>d
You let yourself back down to the ground.

>n
Maisan Mountain
After traveling north for some time you find yourself atop Maisain Mountain, looking out over the farmland of North Jeolla. There's a golf course down there that you might just be able to touch, as well some man-made lakes and Geum River, winding itself towards the Yellow Sea.

You could dance in the sky here, if you wanted. You could probably fly.

>l
Maisan Mountain
Maisain Mountain, looking out over the farmland of North Jeolla. There's a golf course down there that you might just be able to touch, as well some man-made lakes and Geum River, winding itself towards the Yellow Sea.

You could dance in the sky here, if you wanted. You could probably fly.

>n
Napo Field
You fly north until you can fly no more. Then you land here, in a middle school soccer field.

The air is cool and crisp to the touch. Autumn has come, and the birds will be here soon, stopping in this field on their way south. Or maybe they've already been.

There are some parallel bars in the distance. You could swing from those bars, or climb that barren tree. Or you could just keep going north.

* * *

>climb tree
You grab a branch and swing yourself up, into the midst of the blossoms. Kind of like being in a snowglobe.

You are now seated in the cherry blossom trees. You rest your chin on your upraised knees.

>jump down
You get out of the cherry blossom trees.

Blossom Street
A street stretches in front of you. You don't know this street, but it exists. Above you, and all around you, are cherry blossoms: they fill the street gutter; they overflow onto a yellow stripe of paint; they enter your nose, and come out your ears.

You see grass to the left. To the right is a yellow stripe, a streetlight, and a fence.

You could sit here if you wanted. You could run and dance on that yellow stripe. You could lie in the street and let the cherry blossoms bury you. If you wanted.

>climb tree
You grab a branch and swing yourself up, into the midst of the blossoms. Kind of like being in a snowglobe.

You are now seated in the cherry blossom trees. You stare at your toes, and wonder how they got there.

>get down
You get out of the cherry blossom trees.

Blossom Street
A street stretches in front of you. You don't know this street, but it exists. Above you, and all around you, are cherry blossoms: they fill the street gutter; they overflow onto a yellow stripe of paint; they enter your nose, and come out your ears.

You see grass to the left. To the right is a yellow stripe, a streetlight, and a fence.

You could sit here if you wanted. You could run and dance on that yellow stripe. You could lie in the street and let the cherry blossoms bury you. If you wanted.

>climb tree
You grab a branch and swing yourself up, into the midst of the blossoms. Kind of like being in a snowglobe.

You are now seated in the cherry blossom trees. You feel a pebble beneath your buttock.

>go down
You let yourself back down to the ground.

>l
Blossom Street
A street stretches in front of you. You don't know this street, but it exists. Above you, and all around you, are cherry blossoms: they fill the street gutter; they overflow onto a yellow stripe of paint; they enter your nose, and come out your ears.

You see grass to the left. To the right is a yellow stripe, a streetlight, and a fence.

You could sit here if you wanted. You could run and dance on that yellow stripe. You could lie in the street and let the cherry blossoms bury you. If you wanted.

>climb tree
You grab a branch and swing yourself up, into the midst of the blossoms. Kind of like being in a snowglobe.

You are now seated in the cherry blossom trees. Above you is the sky.

>l
Blossom Street (in the cherry blossom trees)
A street stretches in front of you. You don't know this street, but it exists. Above you, and all around you, are cherry blossoms: they fill the street gutter; they overflow onto a yellow stripe of paint; they enter your nose, and come out your ears.

You see grass to the left. To the right is a yellow stripe, a streetlight, and a fence.

You could sit here if you wanted. You could run and dance on that yellow stripe. You could lie in the street and let the cherry blossoms bury you. If you wanted.

>d
You let yourself back down to the ground.

* * *

Blossom Street
A street stretches in front of you. You don't know this street, but it exists. Above you, and all around you, are cherry blossoms: they fill the street gutter; they overflow onto a yellow stripe of paint; they enter your nose, and come out your ears.

You see grass to the left. To the right is a yellow stripe, a streetlight, and a fence.

You could sit here if you wanted. You could run and dance on that yellow stripe. You could lie in the street and let the cherry blossoms bury you. If you wanted.

>sit in gutter
You are now seated in the gutter. You feel a pebble beneath your buttock.

>climb in gutter
I only understood the first part of that-- trying anyway.

(retrying as if you'd typed "climb in.")
You must name something more substantial.

* * *

>sit in gutter
You are now seated in the gutter. You feel a pebble beneath your buttock.

>sit in tree
(getting out of the gutter)
You are now seated on the cherry blossom trees. You feel a pebble beneath your buttock.

>sit in water
You can't see any such thing.

>sit in grass
(getting out of the cherry blossom trees)
You are now seated on the grass. Cross-legged.

* * *

Blossom Street
A street stretches in front of you. You don't know this street, but it exists. Above you, and all around you, are cherry blossoms: they fill the street gutter; they overflow onto a yellow stripe of paint; they enter your nose, and come out your ears.

You see grass to the left. To the right is a yellow stripe, a streetlight, and a fence.

You could sit here if you wanted. You could run and dance on that yellow stripe. You could lie in the street and let the cherry blossoms bury you. If you wanted.

>sit on grass
*** Run-time problem P39: Attempt to say a snippet value which is currently invalid: words 0 to 0.

You are now seated on the grass. You lean back on your hands.

>stand in road
(getting off the grass)
You are now standing on the road. You feel tall.

>sit on sidewalk
(getting off the road)
You can't take that position on the sidewalk.

>sit on sidewalk
You can't take that position on the sidewalk.

>stand on sidewalk
You are now standing on the sidewalk. You can feel the ground through your legs.

>sit on sidewalk
You can't take that position on the sidewalk.

>sit on grass
(getting off the sidewalk)
You are now seated on the grass. You feel a pebble beneath your buttock.

>sit on road
(getting off the grass)
You are now seated on the road. Cross-legged.

>sit on sidewalk
(getting off the road)
You can't take that position on the sidewalk.

>stand on side walk
You are now standing on the sidewalk. The ground under your feet is firm.

>touch sidewalk
The sidewalk feels like a hardened sponge. Great for jumping on.

>feel sidewalk
The sidewalk feels like a hardened sponge. Great for jumping on.

>lick sidewalk
It tastes like the blossoms that cover it: earthy, but sweet.

>x fence
It's a construction fence, with mountains on it. Someone's building something on the far side.

>x mountains
You can't see any such thing.

>sit on fence
That's not something you can sit down on.

* * *

>stand on fence
That's not something you can stand on.

>climb fence
You climb to the top of the fence and have a sit.

>dance on fence
That's not something you can enter.

>eat fence
That's one way to get your body's daily dose of metals.

>look over fence
Looks to be a convention center of some sort, or a hotel. You can see the hole where the pool will be.

>sit on sidewalk
You can't take that position on the sidewalk.

* * *

Blossom Street
A street stretches in front of you. You don't know this street, but it exists. Above you, and all around you, are cherry blossoms: they fill the street gutter; they overflow onto a yellow stripe of paint; they enter your nose, and come out your ears.

You see grass to the left. To the right is a yellow stripe, a streetlight, and a fence.

You could sit here if you wanted. You could run and dance on that yellow stripe. You could lie in the street and let the cherry blossoms bury you. If you wanted.

>sit on sidwalk
You can't see any such thing.

>sit on sidewalk
You are now seated on the sidewalk. You feel a pebble beneath your buttock.

>sing on sidewalk
You are now singing on the sidewalk. You belt it out like a good one.

>climb trree
You can't see any such thing.

>climb tree
You grab a branch and swing yourself up, into the midst of the blossoms. Kind of like being in a snowglobe.

>lie in gutter
(getting off the sidewalk)
You are now reclining on the gutter. Arms outstretched.

>sit in gutter
You are now seated on the gutter. Cross-legged.

>lie in street
You lie down on your back in the middle of the street, and open your mouth. Cherry blossoms rain down like snow, and settle on your legs, your torso, your fingertips.

>wait
The cherry blossoms pile higher.

>z
Time passes.

>z
The cherry blossoms cover you.

>z
Time passes.

>clear
What do you want to clear?

* * *

>x light
It's used to light the way for pedestrians out after dark.

>x beam
The beam vanishes as quickly as it appeared.

>x sky
As you peer at the sky it seems to dance.

>dance in sky
(getting out of the gutter)
You are now dancing in the sky. You spin and you spin, until you can't see straight.

>n
(first leaving the sky)

Maisan Mountain
After traveling north for some time you find yourself atop Maisain Mountain, looking out over the farmland of North Jeolla. There's a golf course down there that you might just be able to touch, as well some man-made lakes and Geum River, winding itself towards the Yellow Sea.

You could dance in the sky here, if you wanted. You could probably fly.

>touch golf course
You stretch out a hand, and can just feel the the crisp smooth grass of a green under your fingers.

>x sky
As you peer at the sky it seems to dance.

>taste sky
You open your mouth and breathe in deep. The sky fills your lungs.

>touch sky
It feels like your thoughts in the morning.

>eat water
Which do you mean, the man-made lakes, or Geum River?

>lakes
Tastes fresh and earthy... no chlorine here.

>drink water
Which do you mean, the man-made lakes, or Geum River?

>river
Tastes fresh and earthy... no chlorine here.

>x brush
You can't see any such thing.

>x trees
Trees and shrubbery cover the mountain, though the valley has been mostly cleared for farmland.

>climb trees
You climb up a tree for an even better view. But before reaching the top you fall back to the ground.

>x ground
It's the ground.

>touch ground
Pretty much what you would expect.

>x earth
You can't see any such thing.

>me
That's not a verb I recognize.

* * *

Blossom Street
A street stretches in front of you. You don't know this street, but it exists. Above you, and all around you, are cherry blossoms: they fill the street gutter; they overflow onto a yellow stripe of paint; they enter your nose, and come out your ears.

You see grass to the left. To the right is a yellow stripe, a streetlight, and a fence.

You could sit here if you wanted. You could run and dance on that yellow stripe. You could lie in the street and let the cherry blossoms bury you. If you wanted.

>x stripe
It's a bold yellow centerline made by a striper. You could taste it if you wanted.

>touch stripe
You slide a finger along the yellow stripe... it leaves a line through the blossoms.

>jump on stripe
You are now jumping on the yellow stripe of paint.

>walk on stripe
You can't see any such thing.

>run on stripe
You are now running on the yellow stripe of paint.

* * *

Blossom Street
A street stretches in front of you. You don't know this street, but it exists. Above you, and all around you, are cherry blossoms: they fill the street gutter; they overflow onto a yellow stripe of paint; they enter your nose, and come out your ears.

You see grass to the left. To the right is a yellow stripe, a streetlight, and a fence.

You could sit here if you wanted. You could run and dance on that yellow stripe. You could lie in the street and let the cherry blossoms bury you. If you wanted.

>walk on stripe
You are now walking on the yellow stripe of paint.

>walk on road
(getting off the yellow stripe of paint)
You are now walking on the road.

>walk on grass
(getting off the road)
You are now walking on the grass.

>walk on fence
That's not something you can enter.

>walk in road
(getting off the grass)
You are now walking on the road. You feel a breeze behind you.

>>x streetlamp
That's not a verb I recognize.

>x streetlamp
It's used to light the way for pedestrians out after dark.

>x lamp
It's used to light the way for pedestrians out after dark.

>put stripe on it
(first trying to take the yellow stripe of paint)
That's hardly portable.

>sit on stripe
(getting off the road)
You are now seated on the yellow stripe of paint. Life is good.

>x fence
It's a construction fence, with mountains on it. Someone's building something on the far side.

>put stripe on it
(first trying to take the yellow stripe of paint)
You'd have to get off the yellow stripe of paint first.

>get up
You get off the yellow stripe of paint.

Blossom Street
A street stretches in front of you. You don't know this street, but it exists. Above you, and all around you, are cherry blossoms: they fill the street gutter; they overflow onto a yellow stripe of paint; they enter your nose, and come out your ears.

You see grass to the left. To the right is a yellow stripe, a streetlight, and a fence.

You could sit here if you wanted. You could run and dance on that yellow stripe. You could lie in the street and let the cherry blossoms bury you. If you wanted.

>sit on stripe
You are now seated on the yellow stripe of paint. You feel a pebble beneath your buttock.

>get off
You get off the yellow stripe of paint.

Blossom Street
A street stretches in front of you. You don't know this street, but it exists. Above you, and all around you, are cherry blossoms: they fill the street gutter; they overflow onto a yellow stripe of paint; they enter your nose, and come out your ears.

You see grass to the left. To the right is a yellow stripe, a streetlight, and a fence.

You could sit here if you wanted. You could run and dance on that yellow stripe. You could lie in the street and let the cherry blossoms bury you. If you wanted.

>x blossoms
The cherry blossoms are everywhere, in everything. Fluffy and white like snow, but without the cold.

>x blossom
Which do you mean, the cherry blossoms, or the cherry blossom trees?

>flowers
The cherry blossoms are everywhere, in everything. Fluffy and white like snow, but without the cold.

>x tree
The indigenous cherry blossom trees bloom once a year in Korea, in the spring, and only for a week.

>x other side
You can't see any such thing.

>x fence
It's a construction fence, with mountains on it. Someone's building something on the far side.

>x far side
Looks to be a convention center of some sort, or a hotel. You can see the hole where the pool will be.

>x other side
You can't see any such thing.

>x far side
Looks to be a convention center of some sort, or a hotel. You can see the hole where the pool will be.

>x construction
Looks to be a convention center of some sort, or a hotel. You can see the hole where the pool will be.

>x convention
You can't see any such thing.

>x side
You can't see any such thing.

>x other side
You can't see any such thing.

* * *

>x far side
Looks to be a convention center of some sort, or a hotel. You can see the hole where the pool will be.

>look over
What do you want to look over?

>fence
Looks to be a convention center of some sort, or a hotel. You can see the hole where the pool will be.

>look over
What do you want to look over?

* * *

>look over fence
Looks to be a convention center of some sort, or a hotel. You can see the hole where the pool will be.

>l
Blossom Street
A street stretches in front of you. You don't know this street, but it exists. Above you, and all around you, are cherry blossoms: they fill the street gutter; they overflow onto a yellow stripe of paint; they enter your nose, and come out your ears.

You see grass to the left. To the right is a yellow stripe, a streetlight, and a fence.

You could sit here if you wanted. You could run and dance on that yellow stripe. You could lie in the street and let the cherry blossoms bury you. If you wanted.

>x gutter
It's a gutter like any other, but filled with cherry blossoms.

>touch gutter
The blossoms make it feel like a pillow of flowers. Wouldn't it be great to lie down here?

>look through fence
Looks to be a convention center of some sort, or a hotel. You can see the hole where the pool will be.

>look other side
I only understood the first part of that-- trying anyway.

(retrying as if you'd typed "look.")
Blossom Street
A street stretches in front of you. You don't know this street, but it exists. Above you, and all around you, are cherry blossoms: they fill the street gutter; they overflow onto a yellow stripe of paint; they enter your nose, and come out your ears.

You see grass to the left. To the right is a yellow stripe, a streetlight, and a fence.

You could sit here if you wanted. You could run and dance on that yellow stripe. You could lie in the street and let the cherry blossoms bury you. If you wanted.

>other sie
That's not a verb I recognize.

>x other side
You can't see any such thing.

>who am i
You are the main character of this story. Normally, you'll want to phrase your input as commands, not questions. I've taken the liberty of demonstrating below.

(retrying as if you'd typed "examine me.")
You have hands, feet, eyes, a nose...

>x blossom
Which do you mean, the cherry blossoms, or the cherry blossom trees?

* * *

Blossom Street
A street stretches in front of you. You don't know this street, but it exists. Above you, and all around you, are cherry blossoms: they fill the street gutter; they overflow onto a yellow stripe of paint; they enter your nose, and come out your ears.

You see grass to the left. To the right is a yellow stripe, a streetlight, and a fence.

You could sit here if you wanted. You could run and dance on that yellow stripe. You could lie in the street and let the cherry blossoms bury you. If you wanted.

>x tree
The indigenous cherry blossom trees bloom once a year in Korea, in the spring, and only for a week.

>x blossom
Which do you mean, the cherry blossoms, or the cherry blossom trees?

* * *

>x trees
The indigenous cherry blossom trees bloom once a year in Korea, in the spring, and only for a week.

>trees
That's not a verb I recognize.

>sleep
You shut your eyes, and doze off... for how long, you don't know, and you don't care.

>rest
You shut your eyes, and doze off... for how long, you don't know, and you don't care.

>sooze
That's not a verb I recognize.

>snozze
That's not a verb I recognize.

>snooze
You shut your eyes, and doze off... for how long, you don't know, and you don't care.

>nap
You shut your eyes, and doze off... for how long, you don't know, and you don't care.

>think about past
I only understood you as far as wanting to think.

>think
What a good idea.

>climb tree
I don't think much is to be achieved by that.

>l
Blossom Street
A street stretches in front of you. You don't know this street, but it exists. Above you, and all around you, are cherry blossoms: they fill the street gutter; they overflow onto a yellow stripe of paint; they enter your nose, and come out your ears.

You see grass to the left. To the right is a yellow stripe, a streetlight, and a fence.

You could sit here if you wanted. You could run and dance on that yellow stripe. You could lie in the street and let the cherry blossoms bury you. If you wanted.

>sit on grass
You are now seated on the grass.

>climb tree
I don't think much is to be achieved by that.

>l
Blossom Street (on the grass)
A street stretches in front of you. You don't know this street, but it exists. Above you, and all around you, are cherry blossoms: they fill the street gutter; they overflow onto a yellow stripe of paint; they enter your nose, and come out your ears.

You see grass to the left. To the right is a yellow stripe, a streetlight, and a fence.

You could sit here if you wanted. You could run and dance on that yellow stripe. You could lie in the street and let the cherry blossoms bury you. If you wanted.

>sing in tree
(getting off the grass)
You are now singing on the cherry blossom trees. You belt it out like a good one.

>l
Blossom Street (in the cherry blossom trees)
A street stretches in front of you. You don't know this street, but it exists. Above you, and all around you, are cherry blossoms: they fill the street gutter; they overflow onto a yellow stripe of paint; they enter your nose, and come out your ears.

You see grass to the left. To the right is a yellow stripe, a streetlight, and a fence.

You could sit here if you wanted. You could run and dance on that yellow stripe. You could lie in the street and let the cherry blossoms bury you. If you wanted.

>climb fence
You climb to the top of the fence and have a sit.

>l
Blossom Street (in the cherry blossom trees)
A street stretches in front of you. You don't know this street, but it exists. Above you, and all around you, are cherry blossoms: they fill the street gutter; they overflow onto a yellow stripe of paint; they enter your nose, and come out your ears.

You see grass to the left. To the right is a yellow stripe, a streetlight, and a fence.

You could sit here if you wanted. You could run and dance on that yellow stripe. You could lie in the street and let the cherry blossoms bury you. If you wanted.

>sit in tree
You are now seated on the cherry blossom trees. You feel a pebble beneath your buttock.

>x pebble
Just a little rock, probably millions of years old.

>take pebble
You move the pebble out of the way, to satisfy your buttock.

>climb on tree
You are now climbing on the cherry blossom trees.

>l
Blossom Street (in the cherry blossom trees)
A street stretches in front of you. You don't know this street, but it exists. Above you, and all around you, are cherry blossoms: they fill the street gutter; they overflow onto a yellow stripe of paint; they enter your nose, and come out your ears.

You see grass to the left. To the right is a yellow stripe, a streetlight, and a fence.

You could sit here if you wanted. You could run and dance on that yellow stripe. You could lie in the street and let the cherry blossoms bury you. If you wanted.

>climb
You are already climbing.

* * *

>x tree
The indigenous cherry blossom trees bloom once a year in Korea, in the spring, and only for a week.

>x gutter
It's a gutter like any other, but filled with cherry blossoms.

>x lamp
You see nothing special about the streetlight.

>x blossom
Which do you mean, the cherry blossoms or the cherry blossom trees?

>cherry
Which do you mean, the cherry blossoms or the cherry blossom trees?

>cherry blossoms
The cherry blossoms are everywhere, in everything. Fluffy and white like snow, but without the cold.

>x stripe
You see nothing special about the yellow stripe of paint.

>x grass
You see nothing special about the grass.

>x road
You see nothing special about the road.

* * *

Blossom Street
A street stretches in front of you. You don't know this street, but it exists. Above you, and all around you, are cherry blossoms: they fill the street gutter; they overflow onto a yellow stripe of paint; they enter your nose, and come out your ears.

You see grass to the left. To the right is a yellow stripe, a streetlight, and a fence.

You could sit here if you wanted. You could run and dance on that yellow stripe. You could lie in the street and let the cherry blossoms bury you. If you wanted.

>z
The cherry blossoms pile higher.

>n
Maisan Mountain
After traveling north for some time you find yourself atop Maisain Mountain, looking out over the farmland of North Jeolla. There's a golf course down there that you might just be able to touch, as well some man-made lakes and Geum River, winding itself towards the Yellow Sea.

You could dance in the sky here, if you wanted. You could probably fly.

* * *

Blossom Street
A street stretches in front of you. You don't know this street, but it exists. Above you, and all around you, are cherry blossoms: they fill the street gutter; they overflow onto a yellow stripe of paint; they enter your nose, and come out your ears.

You see grass to the left. To the right is a yellow stripe, a streetlight, and a fence.

You could sit here if you wanted. You could run and dance on that yellow stripe. You could lie in the street and let the cherry blossoms bury you. If you wanted.

>u
You grab a branch and swing yourself up, into the midst of the blossoms. Kind of like being in a snowglobe.

>d
You sit down, on the ground.

>exit
But you aren't in anything at the moment.

>u
You grab a branch and swing yourself up, into the midst of the blossoms. Kind of like being in a snowglobe.

>w
Maisan Mountain
After traveling west for some time you find yourself atop Maisain Mountain, looking out over the farmland of North Jeolla. There's a golf course down there that you might just be able to touch, as well some man-made lakes and Geum River, winding itself towards the Yellow Sea.

You could dance in the sky here, if you wanted. You could probably fly.

>w
Napo Field
You fly west until you can fly no more. Then you land here, in a middle school soccer field.

The air is cool and crisp to the touch. Autumn has come, and the birds will be here soon, stopping in this field on their way south. Or maybe they've already been.

There are some parallel bars in the distance. You could swing from those bars, or climb that barren tree. Or you could just keep going west.

>w
Temple Spring
You wander west for hours, searching for you don't know what. And then you find it: a fresh spring at the temple of the nirvana fish, spouting clean, cold water from a bamboo chute.

The water flows onto a stone platform, then over the edge, and away.

You can see a cup here.

>x cups
Communal plastic cups are a norm in Korea.

* * *

Blossom Street
A street stretches in front of you. You don't know this street, but it exists. Above you, and all around you, are cherry blossoms: they fill the street gutter; they overflow onto a yellow stripe of paint; they enter your nose, and come out your ears.

You see grass to the left. To the right is a yellow stripe, a streetlight, and a fence.

You could sit here if you wanted. You could run and dance on that yellow stripe. You could lie in the street and let the cherry blossoms bury you. If you wanted.

>sw
You can't go that way.

>s
Maisan Mountain
After traveling south for some time you find yourself atop Maisain Mountain, looking out over the farmland of North Jeolla. There's a golf course down there that you might just be able to touch, as well some man-made lakes and Geum River, winding itself towards the Yellow Sea.

You could dance in the sky here, if you wanted. You could probably fly.

>d
You can't go that way.

>u
You can't go that way.

* * *

Blossom Street
A street stretches in front of you. You don't know this street, but it exists. Above you, and all around you, are cherry blossoms: they fill the street gutter; they overflow onto a yellow stripe of paint; they enter your nose, and come out your ears.

You see grass to the left. To the right is a yellow stripe, a streetlight, and a fence.

You could sit here if you wanted. You could run and dance on that yellow stripe. You could lie in the street and let the cherry blossoms bury you. If you wanted.

>sit on road
You are now seated on the road. You feel a pebble beneath your buttock.

>d
You sit down, on the ground.

>climb tree
You grab a branch and swing yourself up, into the midst of the blossoms. Kind of like being in a snowglobe.

>d
You sit down, on the ground.

* * *

>sit on road
You are now seated on the road. You feel a pebble beneath your buttock.

>up
If you want to climb something, try the command "climb"; if you want to enter the sky, try "jump" or "fly."

>climb tree
(getting off the road)
You grab a branch and swing yourself up, into the midst of the blossoms. Kind of like being in a snowglobe.

You are now seated in the cherry blossom trees. You feel a breeze behind you.

>down
You are not on anything.

>down
You are not on anything.

>get down
You get out of the cherry blossom trees.

Blossom Street
A street stretches in front of you. You don't know this street, but it exists. Above you, and all around you, are cherry blossoms: they fill the street gutter; they overflow onto a yellow stripe of paint; they enter your nose, and come out your ears.

You see grass to the left. To the right is a yellow stripe, a streetlight, and a fence.

You could sit here if you wanted. You could run and dance on that yellow stripe. You could lie in the street and let the cherry blossoms bury you. If you wanted.

* * *

Blossom Street
A street stretches in front of you. You don't know this street, but it exists. Above you, and all around you, are cherry blossoms: they fill the street gutter; they overflow onto a yellow stripe of paint; they enter your nose, and come out your ears.

You see grass to the left. To the right is a yellow stripe, a streetlight, and a fence.

You could sit here if you wanted. You could run and dance on that yellow stripe. You could lie in the street and let the cherry blossoms bury you. If you wanted.

>x fence
It's a construction fence, with mountains on it. Someone's building something on the far side.

>sit on fence
You climb to the top of the fence.

You climb to the top of the fence and run its length, like a balance beam.

You are now seated on the fence. You feel a pebble beneath your buttock.

>l
Blossom Street (on the fence)
A street stretches in front of you. You don't know this street, but it exists. Above you, and all around you, are cherry blossoms: they fill the street gutter; they overflow onto a yellow stripe of paint; they enter your nose, and come out your ears.

You see grass to the left. To the right is a yellow stripe, a streetlight, and a fence.

You could sit here if you wanted. You could run and dance on that yellow stripe. You could lie in the street and let the cherry blossoms bury you. If you wanted.

>run on fence
You are now running on the fence. You feel a breeze behind you.

>d
You let yourself back down to the ground.

>run on fence
You climb to the top of the fence and run its length, like a balance beam.

You are now running on the fence. Around and around in circles.

>run on fence
You are now running on the fence. Back and forth, "till you're panting and out of breath.

* * *

Blossom Street
A street stretches in front of you. You don't know this street, but it exists. Above you, and all around you, are cherry blossoms: they fill the street gutter; they overflow onto a yellow stripe of paint; they enter your nose, and come out your ears.

You see grass to the left. To the right is a yellow stripe, a streetlight, and a fence.

You could sit here if you wanted. You could run and dance on that yellow stripe. You could lie in the street and let the cherry blossoms bury you. If you wanted.

>sit on fence
You hoist yourself to the top of the fence.

You are now seated on the fence. You feel a pebble beneath your buttock.

>run on fence
You are now running on the fence. Around and around in circles.

>jump
You jump on the spot. You feel a breeze behind you.

>l
Blossom Street (on the fence)
A street stretches in front of you. You don't know this street, but it exists. Above you, and all around you, are cherry blossoms: they fill the street gutter; they overflow onto a yellow stripe of paint; they enter your nose, and come out your ears.

You see grass to the left. To the right is a yellow stripe, a streetlight, and a fence.

You could sit here if you wanted. You could run and dance on that yellow stripe. You could lie in the street and let the cherry blossoms bury you. If you wanted.

>d
You let yourself back down to the ground.

>jump on fence
You hoist yourself to the top of the fence.

You are now jumping on the fence.

>l
Blossom Street (on the fence)
A street stretches in front of you. You don't know this street, but it exists. Above you, and all around you, are cherry blossoms: they fill the street gutter; they overflow onto a yellow stripe of paint; they enter your nose, and come out your ears.

You see grass to the left. To the right is a yellow stripe, a streetlight, and a fence.

You could sit here if you wanted. You could run and dance on that yellow stripe. You could lie in the street and let the cherry blossoms bury you. If you wanted.

>jump over fence
I only understood the first part of that-- trying anyway.

(retrying as if you'd typed "jump.")
You jump on the spot. Life is good.

>l
Blossom Street (on the fence)
A street stretches in front of you. You don't know this street, but it exists. Above you, and all around you, are cherry blossoms: they fill the street gutter; they overflow onto a yellow stripe of paint; they enter your nose, and come out your ears.

You see grass to the left. To the right is a yellow stripe, a streetlight, and a fence.

You could sit here if you wanted. You could run and dance on that yellow stripe. You could lie in the street and let the cherry blossoms bury you. If you wanted.

* * *

>d
You let yourself back down to the ground.

>climb fence
You hoist yourself to the top of the fence.

You are now climbing on the fence. A bird flies by, and looks at you.

>jump
You jump on the spot. It feels like you've been here before.

>l
Blossom Street (on the fence)
A street stretches in front of you. You don't know this street, but it exists. Above you, and all around you, are cherry blossoms: they fill the street gutter; they overflow onto a yellow stripe of paint; they enter your nose, and come out your ears.

You see grass to the left. To the right is a yellow stripe, a streetlight, and a fence.

You could sit here if you wanted. You could run and dance on that yellow stripe. You could lie in the street and let the cherry blossoms bury you. If you wanted.

* * *

Blossom Street
A street stretches in front of you. You don't know this street, but it exists. Above you, and all around you, are cherry blossoms: they fill the street gutter; they overflow onto a yellow stripe of paint; they enter your nose, and come out your ears.

You see grass to the left. To the right is a yellow stripe, a streetlight, and a fence.

You could sit here if you wanted. You could run and dance on that yellow stripe. You could lie in the street and let the cherry blossoms bury you. If you wanted.

>climb fence
You hoist yourself to the top of the fence.

You are now seated on the fence. You feel a breeze behind you.

>down
You let yourself back down to the ground.

>climb trees
You grab a branch and swing yourself up, into the midst of the blossoms. Kind of like being in a snowglobe.

You are now seated in the cherry blossom trees. Life is good.

>down
You let yourself back down to the ground.

>get down
But you aren't in anything at the moment.

* * *

Blossom Street
A street stretches in front of you. You don't know this street, but it exists. Above you, and all around you, are cherry blossoms: they fill the street gutter; they overflow onto a yellow stripe of paint; they enter your nose, and come out your ears.

You see grass to the left. To the right is a yellow stripe, a streetlight, and a fence.

You could sit here if you wanted. You could run and dance on that yellow stripe. You could lie in the street and let the cherry blossoms bury you. If you wanted.

>sit in trees
You grab a branch and swing yourself up, into the midst of the blossoms. Kind of like being in a snowglobe.

You are now seated in the cherry blossom trees.

>showme trees
(the cherry blossom trees)
cherry blossom trees - open container
    yourself - person
        your head (part of yourself) - head
        your nose (part of yourself) - nose
        your eyes (part of yourself) - eyes
        your eye (part of yourself) - eye
        your ears (part of yourself) - ears
        your ear (part of yourself) - ear
        your chin (part of yourself) - chin
        your hair (part of yourself) - hair
        your face (part of yourself) - face
        your hands (part of yourself) - hands
        your hand (part of yourself) - hand
        your fingers (part of yourself) - fingers
        your finger (part of yourself) - finger
        your legs (part of yourself) - legs
        your leg (part of yourself) - leg
        your feet (part of yourself) - feet
        your foot (part of yourself) - foot
        your knees (part of yourself) - knees
        your knee (part of yourself) - knee
        your Toes (part of yourself) - Toes
        your toe (part of yourself) - toe
location: in Blossom Street
unlit; inedible; portable; singular-named; improper-named; neuter; ordinarily enumerated; seen; unfamiliar; unswingable; not-one-of-many; not drinkable; weak_smelling; soft_sounding
printed name: cherry blossom trees
initial appearance: The indigenous cherry blossom trees bloom once a year in Korea, in the spring, and only for a week.
printed plural name: containers
feeling: The delicate flowers feel like warm snow.
flavor: You lick the trunk of one of the trees, and get a splinter in your tongue.
odor: something sweet and dewy, mixed with bark
sound: the wind in the flowers
enterable; opaque; open; unopenable; unlocked
carrying capacity: 100
known-key: no-key
posture: seated

>fly in trees
You can't take that position on the cherry blossom trees.

* * *

>sit in trees
You grab a branch and swing yourself up, into the midst of the blossoms. Kind of like being in a snowglobe.

You are now seated in the cherry blossom trees.

>climb trees
(getting out of the cherry blossom trees)
You hoist yourself to the top of the fence.

You are now seated on the fence.

>sit on road
(getting off the fence)
You are now seated on the road. You feel a pebble beneath your buttock.

>sit in gutter
(getting off the road)
You are now seated in the gutter. Cross-legged.

>sing
You are now singing in the gutter. You belt it out like a good one.

>stand on road
(getting out of the gutter)
You are now standing on the road. You feel tall.

>sing
You are now singing on the road. You feel a breeze behind you.

>jump on fence
(getting off the road)
You hoist yourself to the top of the fence.

You are now jumping on the fence. Life is good.

>sit in grass
(getting off the fence)
You are now seated on the grass.

>swing on fence
You can't really swing on that.

* * *

Blossom Street
A street stretches in front of you. You don't know this street, but it exists. Above you, and all around you, are cherry blossoms: they fill the street gutter; they overflow onto a yellow stripe of paint; they enter your nose, and come out your ears.

You see grass to the left. To the right is a yellow stripe, a streetlight, and a fence.

You could sit here if you wanted. You could run and dance on that yellow stripe. You could lie in the street and let the cherry blossoms bury you. If you wanted.

>sit in tree
You grab a branch and swing yourself up, into the midst of the blossoms. Kind of like being in a snowglobe.

You are now seated cherry blossom treesbar. You feel a pebble beneath your buttock.

>showme trees
(the cherry blossom trees)
cherry blossom trees - open container
    yourself - person
        your head (part of yourself) - head
        your nose (part of yourself) - nose
        your eyes (part of yourself) - eyes
        your eye (part of yourself) - eye
        your ears (part of yourself) - ears
        your ear (part of yourself) - ear
        your chin (part of yourself) - chin
        your hair (part of yourself) - hair
        your face (part of yourself) - face
        your hands (part of yourself) - hands
        your hand (part of yourself) - hand
        your fingers (part of yourself) - fingers
        your finger (part of yourself) - finger
        your legs (part of yourself) - legs
        your leg (part of yourself) - leg
        your feet (part of yourself) - feet
        your foot (part of yourself) - foot
        your knees (part of yourself) - knees
        your knee (part of yourself) - knee
        your Toes (part of yourself) - Toes
        your toe (part of yourself) - toe
location: in Blossom Street
unlit; inedible; portable; singular-named; improper-named; neuter; ordinarily enumerated; seen; unfamiliar; unswingable; not-one-of-many; not drinkable; weak_smelling; soft_sounding
printed name: cherry blossom trees
initial appearance: The indigenous cherry blossom trees bloom once a year in Korea, in the spring, and only for a week.
printed plural name: containers
feeling: The delicate flowers feel like warm snow.
flavor: You lick the trunk of one of the trees, and get a splinter in your tongue.
odor: something sweet and dewy, mixed with bark
sound: the wind in the flowers
enterable; opaque; open; unopenable; unlocked
carrying capacity: 100
known-key: no-key
posture: seated

* * *

Blossom Street
A street stretches in front of you. You don't know this street, but it exists. Above you, and all around you, are cherry blossoms: they fill the street gutter; they overflow onto a yellow stripe of paint; they enter your nose, and come out your ears.

You see grass to the left. To the right is a yellow stripe, a streetlight, and a fence.

You could sit here if you wanted. You could run and dance on that yellow stripe. You could lie in the street and let the cherry blossoms bury you. If you wanted.

>howme cherry blossom trees
That's not a verb I recognize.

>showme cherry blossom trees
cherry blossom trees - open container
location: in Blossom Street
unlit; inedible; portable; singular-named; improper-named; neuter; ordinarily enumerated; seen; unfamiliar; unswingable; not-one-of-many; not drinkable; weak_smelling; soft_sounding
printed name: cherry blossom trees
initial appearance: The indigenous cherry blossom trees bloom once a year in Korea, in the spring, and only for a week.
printed plural name: containers
feeling: The delicate flowers feel like warm snow.
flavor: You lick the trunk of one of the trees, and get a splinter in your tongue.
odor: something sweet and dewy, mixed with bark
sound: the wind in the flowers
enterable; opaque; open; unopenable; unlocked
carrying capacity: 100
known-key: no-key
posture: seated

>x trees
You see nothing special about the cherry blossom trees.

>sit in trees
You grab a branch and swing yourself up, into the midst of the blossoms. Kind of like being in a snowglobe.

You are now seated cherry blossom treesbar. You feel a pebble beneath your buttock.

>sit on road
(getting out of the cherry blossom trees)
You are now seated roadboo. You feel a breeze behind you.

* * *

Blossom Street
A street stretches in front of you. You don't know this street, but it exists. Above you, and all around you, are cherry blossoms: they fill the street gutter; they overflow onto a yellow stripe of paint; they enter your nose, and come out your ears.

You see grass to the left. To the right is a yellow stripe, a streetlight, and a fence.

You could sit here if you wanted. You could run and dance on that yellow stripe. You could lie in the street and let the cherry blossoms bury you. If you wanted.

>sit on tree
You grab a branch and swing yourself up, into the midst of the blossoms. Kind of like being in a snowglobe.

You are now seated in the cherry blossom trees.

>stand in road
(getting out of the cherry blossom trees)
You are now standing on the road. You feel tall.

>sing in tree
(getting off the road)
You grab a branch and swing yourself up, into the midst of the blossoms. Kind of like being in a snowglobe.

You are now singing in the cherry blossom trees. You belt it out like a good one.

>l
Blossom Street (in the cherry blossom trees)
A street stretches in front of you. You don't know this street, but it exists. Above you, and all around you, are cherry blossoms: they fill the street gutter; they overflow onto a yellow stripe of paint; they enter your nose, and come out your ears.

You see grass to the left. To the right is a yellow stripe, a streetlight, and a fence.

You could sit here if you wanted. You could run and dance on that yellow stripe. You could lie in the street and let the cherry blossoms bury you. If you wanted.

>stand in gutter
(getting out of the cherry blossom trees)
You are now standing in the gutter. You can feel it through your legs.

>sit in gutter
You are now seated in the gutter. You feel a breeze behind you.

>n
(first leaving the gutter)

Maisan Mountain
After traveling north for some time you find yourself atop Maisain Mountain, looking out over the farmland of North Jeolla. There's a golf course down there that you might just be able to touch, as well some man-made lakes and Geum River, winding itself towards the Yellow Sea.

You could dance in the sky here, if you wanted. You could probably fly.

>climb tree
That's not something you can enter.

>swim in lake
You jump into a lake. Cool water flows over you.

>l
Maisan Mountain (in the man-made lakes)
After traveling north for some time you find yourself atop Maisain Mountain, looking out over the farmland of North Jeolla. There's a golf course down there that you might just be able to touch, as well some man-made lakes and Geum River, winding itself towards the Yellow Sea.

You could dance in the sky here, if you wanted. You could probably fly.

>swim
What do you want to swim in?

>lakes
You swim around some more.

>stand on ground
(getting out of the man-made lakes)
You are now standing on the ground. It feels firm beneath your feet.

>sand
That's not a verb I recognize.

>stand
You are already standing.

>stand on earth
(getting out of the ground)
You are now standing on the farmland. It seems to move under your feet. Maybe it's just the earth spinning.

>sing on golf course
(getting off the farmland)
You are now singing on the golf course. No one to say if you're any good or not.

>sing
You are already singing.

>run
You are now running on the golf course. Around and around in circles.

>walk
You are now walking on the golf course.

>sit down
You are now seated on the golf course. You feel a pebble beneath your buttock.

>fly in lakes
(getting off the golf course)
You can't take that position in the man-made lakes.

>sit in lakes
You can't take that position in the man-made lakes.

>sing in laks
You can't see any such thing.

>sing in lakes
You can't take that position in the man-made lakes.

>swim
What do you want to swim in?

* * *

>lakes
You swim around some more.

>l
Maisan Mountain (in the man-made lakes)
After traveling north for some time you find yourself atop Maisain Mountain, looking out over the farmland of North Jeolla. There's a golf course down there that you might just be able to touch, as well some man-made lakes and Geum River, winding itself towards the Yellow Sea.

You could dance in the sky here, if you wanted. You could probably fly.

>dance in sky
(getting out of the man-made lakes)
You are now dancing in the sky. Life is good.

>sit in sky
You can't take that position in the sky.

>stand in sky
You can't take that position in the sky.

>stand in river
(getting out of the sky)
You are now standing in Geum River.

>stand in lakes
(getting out of Geum River)
You are now standing in the man-made lakes. You are more like a spaghetti noodle now.

>sit in lakes
You can't take that position in the man-made lakes.

* * *

Blossom Street
A street stretches in front of you. You don't know this street, but it exists. Above you, and all around you, are cherry blossoms: they fill the street gutter; they overflow onto a yellow stripe of paint; they enter your nose, and come out your ears.

You see grass to the left. To the right is a yellow stripe, a streetlight, and a fence.

You could sit here if you wanted. You could run and dance on that yellow stripe. You could lie in the street and let the cherry blossoms bury you. If you wanted.

>climb trees
You grab a branch and swing yourself up, into the midst of the blossoms. Kind of like being in a snowglobe.

You are now seated in the cherry blossom trees. You feel a breeze behind you.

>n
(first leaving the cherry blossom trees)

Maisan Mountain
After traveling north for some time you find yourself atop Maisain Mountain, looking out over the farmland of North Jeolla. There's a golf course down there that you might just be able to touch, as well some man-made lakes and Geum River, winding itself towards the Yellow Sea.

You could dance in the sky here, if you wanted. You could probably fly.

>climb tree
You climb up a tree for an even better view.

You are now seated in the trees. You feel a pebble beneath your buttock.

>sing
You are now singing in the trees.

>dance
You can't take that position in the trees.

>stand
You are now standing in the trees. You feel tall.

>sing on golf course
(getting out of the trees)
You are now singing on the golf course.

>x land
Dark earth and rice paddies as far as the eye can see. These farms are the reason North Jeolla is known as the bread basket of Korea.

>n
(first leaving the golf course)

Napo Field
You fly north until you can fly no more. Then you land here, in a middle school soccer field.

The air is cool and crisp to the touch. Autumn has come, and the birds will be here soon, stopping in this field on their way south. Or maybe they've already been.

There are some parallel bars in the distance. You could swing from those bars, or climb that barren tree. Or you could just keep going north.

>n
Temple Spring
You wander north for hours, searching for you don't know what. And then you find it: a fresh spring at the temple of the nirvana fish, spouting clean, cold water from a bamboo chute.

The water flows onto a stone platform, then over the edge, and away.

>sit down
You are now seated. Life is good.

>n
(first standing up)

Kimchi Pots
Walking north you come upon some gaint Kimchi pots.

If there was kimchi in one of those pots you could eat it... you could put it in your mouth and let the spices soak your tongue.

You could climb into one of the pots and sing until your voice was hoarse.

You could stand on top of one of them and jump up and down until someone made you stop.

You could do a million things. Or nothing at all.

* * *

>climb trees
You grab a branch and swing yourself up, into the midst of the blossoms. Kind of like being in a snowglobe.

You are now seated in the cherry blossom trees. You feel a breeze behind you.

>d
You get out of the cherry blossom trees.

Blossom Street
A street stretches in front of you. You don't know this street, but it exists. Above you, and all around you, are cherry blossoms: they fill the street gutter; they overflow onto a yellow stripe of paint; they enter your nose, and come out your ears.

You see grass to the left. To the right is a yellow stripe, a streetlight, and a fence.

You could sit here if you wanted. You could run and dance on that yellow stripe. You could lie in the street and let the cherry blossoms bury you. If you wanted.

>climb fence
You hoist yourself to the top of the fence.

You are now seated on the fence. You feel a breeze behind you.

>d
You let yourself back down to the ground.

>climb trees
You grab a branch and swing yourself up, into the midst of the blossoms. Kind of like being in a snowglobe.

You are now seated in the cherry blossom trees.

>d
You let yourself back down to the ground.

>dance in sky
You are now dancing in the sky. Life is good.

>d
You lower yourself down, getting as close as you can to the earth.

>d
But you aren't in anything at the moment.
You lower yourself down, getting as close as you can to the earth.

>d
But you aren't in anything at the moment.
You lower yourself down, getting as close as you can to the earth.

>dance in sky
You are now dancing in the sky. You spin and you spin, until you can't see straight.

>d
You lower yourself down, getting as close as you can to the earth.

* * *

>d
But you aren't in anything at the moment.
You lower yourself down, getting as close as you can to the earth.

>n
Maisan Mountain
After traveling north for some time you find yourself atop Maisain Mountain, looking out over the farmland of North Jeolla. There's a golf course down there that you might just be able to touch, as well some man-made lakes and Geum River, winding itself towards the Yellow Sea.

You could dance in the sky here, if you wanted. You could probably fly.

>n
Napo Field
You fly north until you can fly no more. Then you land here, in a middle school soccer field.

The air is cool and crisp to the touch. Autumn has come, and the birds will be here soon, stopping in this field on their way south. Or maybe they've already been.

There are some parallel bars in the distance. You could swing from those bars, or climb that barren tree. Or you could just keep going north.

>stand on bars
You are now standing in the parallel bars.

* * *

>d
You get out of the cherry blossom trees.

Blossom Street
A street stretches in front of you. You don't know this street, but it exists. Above you, and all around you, are cherry blossoms: they fill the street gutter; they overflow onto a yellow stripe of paint; they enter your nose, and come out your ears.

You see grass to the left. To the right is a yellow stripe, a streetlight, and a fence.

You could sit here if you wanted. You could run and dance on that yellow stripe. You could lie in the street and let the cherry blossoms bury you. If you wanted.

>fly in sky
You are now flying in the sky. You feel millions of Nitrogen and Oxygen particles hitting your skin.

* * *

>l
Blossom Street (in the sky)
A street stretches in front of you. You don't know this street, but it exists. Above you, and all around you, are cherry blossoms: they fill the street gutter; they overflow onto a yellow stripe of paint; they enter your nose, and come out your ears.

You see grass to the left. To the right is a yellow stripe, a streetlight, and a fence.

You could sit here if you wanted. You could run and dance on that yellow stripe. You could lie in the street and let the cherry blossoms bury you. If you wanted.

* * *

Blossom Street
A street stretches in front of you. You don't know this street, but it exists. Above you, and all around you, are cherry blossoms: they fill the street gutter; they overflow onto a yellow stripe of paint; they enter your nose, and come out your ears.

You see grass to the left. To the right is a yellow stripe, a streetlight, and a fence.

You could sit here if you wanted. You could run and dance on that yellow stripe. You could lie in the street and let the cherry blossoms bury you. If you wanted.

>sit down
You are now seated. You rest your chin on your upraised knees.

>n
(first standing up)

Maisan Mountain
After traveling north for some time you find yourself atop Maisain Mountain, looking out over the farmland of North Jeolla. There's a golf course down there that you might just be able to touch, as well some man-made lakes and Geum River, winding itself towards the Yellow Sea.

You could dance in the sky here, if you wanted. You could probably fly.

>climb tree
You climb up a tree for an even better view.

You are now seated in the trees. Cross-legged.

>down
You lower yourself down, getting as close as you can to the earth.

>l
Maisan Mountain (in the trees)
After traveling north for some time you find yourself atop Maisain Mountain, looking out over the farmland of North Jeolla. There's a golf course down there that you might just be able to touch, as well some man-made lakes and Geum River, winding itself towards the Yellow Sea.

You could dance in the sky here, if you wanted. You could probably fly.

>get down
You get out of the trees.

Maisan Mountain
After traveling north for some time you find yourself atop Maisain Mountain, looking out over the farmland of North Jeolla. There's a golf course down there that you might just be able to touch, as well some man-made lakes and Geum River, winding itself towards the Yellow Sea.

You could dance in the sky here, if you wanted. You could probably fly.

* * *

Blossom Street
A street stretches in front of you. You don't know this street, but it exists. Above you, and all around you, are cherry blossoms: they fill the street gutter; they overflow onto a yellow stripe of paint; they enter your nose, and come out your ears.

You see grass to the left. To the right is a yellow stripe, a streetlight, and a fence.

You could sit here if you wanted. You could run and dance on that yellow stripe. You could lie in the street and let the cherry blossoms bury you. If you wanted.

>enter sky
You get into the sky.

>down
You lower yourself down, getting as close as you can to the earth.

* * *

Blossom Street
A street stretches in front of you. You don't know this street, but it exists. Above you, and all around you, are cherry blossoms: they fill the street gutter; they overflow onto a yellow stripe of paint; they enter your nose, and come out your ears.

You see grass to the left. To the right is a yellow stripe, a streetlight, and a fence.

You could sit here if you wanted. You could run and dance on that yellow stripe. You could lie in the street and let the cherry blossoms bury you. If you wanted.

>dance in sky
You are now dancing in the sky.

>l
Blossom Street (in the sky)
A street stretches in front of you. You don't know this street, but it exists. Above you, and all around you, are cherry blossoms: they fill the street gutter; they overflow onto a yellow stripe of paint; they enter your nose, and come out your ears.

You see grass to the left. To the right is a yellow stripe, a streetlight, and a fence.

You could sit here if you wanted. You could run and dance on that yellow stripe. You could lie in the street and let the cherry blossoms bury you. If you wanted.

* * *

>d
You lower yourself down, getting as close as you can to the earth.

>climb trees
(getting out of the sky)
You grab a branch and swing yourself up, into the midst of the blossoms. Kind of like being in a snowglobe.

You are now seated in the cherry blossom trees. You feel a pebble beneath your buttock.

>d
You let yourself back down to the ground.

>showme the sky
sky - backdrop
location: in Blossom Street
unlit; inedible; fixed in place; scenery; singular-named; improper-named; neuter; ordinarily enumerated; unseen; unfamiliar; unswingable; not-one-of-many; not drinkable; weak_smelling; soft_sounding
description: As you peer at the sky it seems to dance.
printed name: sky
printed plural name: backdrops
feeling: It feels like your thoughts in the morning.
flavor: You open your mouth and breathe in deep. The sky fills your lungs.
odor: fresh life
sound: birds and the wind in the trees
enterable; open; container
posture: flying

>showme cherry blossom trees
cherry blossom trees - open container
location: in Blossom Street
unlit; inedible; fixed in place; scenery; singular-named; improper-named; neuter; ordinarily enumerated; seen; unfamiliar; unswingable; not-one-of-many; not drinkable; weak_smelling; soft_sounding
description: The indigenous cherry blossom trees bloom once a year in Korea, in the spring, and only for a week.
printed name: cherry blossom trees
printed plural name: containers
feeling: The delicate flowers feel like warm snow.
flavor: You lick the trunk of one of the trees, and get a splinter in your tongue.
odor: something sweet and dewy, mixed with bark
sound: the wind in the flowers
enterable; opaque; open; unopenable; unlocked
carrying capacity: 100
known-key: no-key
posture: seated

* * *

>dance in sky
You are now dancing in the sky.

>d
You lower yourself down, getting as close as you can to the earth.

* * *

>l
Blossom Street
A street stretches in front of you. You don't know this street, but it exists. Above you, and all around you, are cherry blossoms: they fill the street gutter; they overflow onto a yellow stripe of paint; they enter your nose, and come out your ears.

You see grass to the left. To the right is a yellow stripe, a streetlight, and a fence.

You could sit here if you wanted. You could run and dance on that yellow stripe. You could lie in the street and let the cherry blossoms bury you. If you wanted.

>dance in sky
You are now dancing in the sky. You spin and you spin, until you can't see straight.

>l
Blossom Street (in the sky)
A street stretches in front of you. You don't know this street, but it exists. Above you, and all around you, are cherry blossoms: they fill the street gutter; they overflow onto a yellow stripe of paint; they enter your nose, and come out your ears.

You see grass to the left. To the right is a yellow stripe, a streetlight, and a fence.

You could sit here if you wanted. You could run and dance on that yellow stripe. You could lie in the street and let the cherry blossoms bury you. If you wanted.

* * *

Blossom Street
A street stretches in front of you. You don't know this street, but it exists. Above you, and all around you, are cherry blossoms: they fill the street gutter; they overflow onto a yellow stripe of paint; they enter your nose, and come out your ears.

You see grass to the left. To the right is a yellow stripe, a streetlight, and a fence.

You could sit here if you wanted. You could run and dance on that yellow stripe. You could lie in the street and let the cherry blossoms bury you. If you wanted.

>fly
You are now flying in the sky. Like the fastest things on earth.

>l
Blossom Street
A street stretches in front of you. You don't know this street, but it exists. Above you, and all around you, are cherry blossoms: they fill the street gutter; they overflow onto a yellow stripe of paint; they enter your nose, and come out your ears.

You see grass to the left. To the right is a yellow stripe, a streetlight, and a fence.

You could sit here if you wanted. You could run and dance on that yellow stripe. You could lie in the street and let the cherry blossoms bury you. If you wanted.

>dance in sky
You are now dancing in the sky.

* * *

>l
Blossom Street
A street stretches in front of you. You don't know this street, but it exists. Above you, and all around you, are cherry blossoms: they fill the street gutter; they overflow onto a yellow stripe of paint; they enter your nose, and come out your ears.

You see grass to the left. To the right is a yellow stripe, a streetlight, and a fence.

You could sit here if you wanted. You could run and dance on that yellow stripe. You could lie in the street and let the cherry blossoms bury you. If you wanted.

>get down
But you aren't in anything at the moment.

>l
Blossom Street
A street stretches in front of you. You don't know this street, but it exists. Above you, and all around you, are cherry blossoms: they fill the street gutter; they overflow onto a yellow stripe of paint; they enter your nose, and come out your ears.

You see grass to the left. To the right is a yellow stripe, a streetlight, and a fence.

You could sit here if you wanted. You could run and dance on that yellow stripe. You could lie in the street and let the cherry blossoms bury you. If you wanted.

>dance in sky
You are now dancing in the sky. You feel a breeze behind you.

>showme player
There seems to be no such object anywhere in the model world.

>showme the player
There seems to be no such object anywhere in the model world.

>showme the sky
sky - backdrop
    yourself - person
        your head (part of yourself) - head
        your nose (part of yourself) - nose
        your eyes (part of yourself) - eyes
        your eye (part of yourself) - eye
        your ears (part of yourself) - ears
        your ear (part of yourself) - ear
        your chin (part of yourself) - chin
        your hair (part of yourself) - hair
        your face (part of yourself) - face
        your hands (part of yourself) - hands
        your hand (part of yourself) - hand
        your fingers (part of yourself) - fingers
        your finger (part of yourself) - finger
        your legs (part of yourself) - legs
        your leg (part of yourself) - leg
        your feet (part of yourself) - feet
        your foot (part of yourself) - foot
        your knees (part of yourself) - knees
        your knee (part of yourself) - knee
        your Toes (part of yourself) - Toes
        your toe (part of yourself) - toe
location: in Blossom Street
unlit; inedible; fixed in place; scenery; singular-named; improper-named; neuter; ordinarily enumerated; unseen; unfamiliar; unswingable; not-one-of-many; not drinkable; weak_smelling; soft_sounding
description: As you peer at the sky it seems to dance.
printed name: sky
printed plural name: backdrops
feeling: It feels like your thoughts in the morning.
flavor: You open your mouth and breathe in deep. The sky fills your lungs.
odor: fresh life
sound: birds and the wind in the trees
enterable; open; container
posture: flying

>dance in the sky
You are now dancing in the sky. You spin and you spin, until you can't see straight.

>d
You lower yourself down, getting as close as you can to the earth.

* * *

>l
Blossom Street
A street stretches in front of you. You don't know this street, but it exists. Above you, and all around you, are cherry blossoms: they fill the street gutter; they overflow onto a yellow stripe of paint; they enter your nose, and come out your ears.

You see grass to the left. To the right is a yellow stripe, a streetlight, and a fence.

You could sit here if you wanted. You could run and dance on that yellow stripe. You could lie in the street and let the cherry blossoms bury you. If you wanted.

>climb tree
You grab a branch and swing yourself up, into the midst of the blossoms. Kind of like being in a snowglobe.

You are now seated in the cherry blossom trees. You lean back on your hands.

>fly
(getting out of the cherry blossom trees)
You are already flying.

>fly
You are already flying.

>l
Blossom Street (in the sky)
A street stretches in front of you. You don't know this street, but it exists. Above you, and all around you, are cherry blossoms: they fill the street gutter; they overflow onto a yellow stripe of paint; they enter your nose, and come out your ears.

You see grass to the left. To the right is a yellow stripe, a streetlight, and a fence.

You could sit here if you wanted. You could run and dance on that yellow stripe. You could lie in the street and let the cherry blossoms bury you. If you wanted.

>fly in the ksy
A lot of words like prepositions and adverbs are not necessary in interactive fiction.

(retrying as if you'd typed " in the ksy.")
I only understood you as far as wanting to in.

>fly in the sky
You are now flying in the sky. Slowly, lazily, just for fun.

>fly in trees
You are now flying in the sky.

>fly
You are already flying.

>get out
You get out of the sky.

Blossom Street

>fly
You are now flying. You feel millions of Nitrogen and Oxygen particles hitting your skin.

>l
Blossom Street
A street stretches in front of you. You don't know this street, but it exists. Above you, and all around you, are cherry blossoms: they fill the street gutter; they overflow onto a yellow stripe of paint; they enter your nose, and come out your ears.

You see grass to the left. To the right is a yellow stripe, a streetlight, and a fence.

You could sit here if you wanted. You could run and dance on that yellow stripe. You could lie in the street and let the cherry blossoms bury you. If you wanted.

>climb trees
You grab a branch and swing yourself up, into the midst of the blossoms. Kind of like being in a snowglobe.

You are now seated in the cherry blossom trees. You stare at your toes, and wonder how they got there.

>fly
(getting out of the cherry blossom trees)

>fly
You are already flying.

>fly in tree
You are now flying in the sky. You go high, and then glide slowly towards the earth.

>climb trees
(getting out of the sky)
You grab a branch and swing yourself up, into the midst of the blossoms. Kind of like being in a snowglobe.

You are now seated in the cherry blossom trees. The world looks different.

>fly
(getting out of the cherry blossom trees)

>l
Blossom Street (in the sky)
A street stretches in front of you. You don't know this street, but it exists. Above you, and all around you, are cherry blossoms: they fill the street gutter; they overflow onto a yellow stripe of paint; they enter your nose, and come out your ears.

You see grass to the left. To the right is a yellow stripe, a streetlight, and a fence.

You could sit here if you wanted. You could run and dance on that yellow stripe. You could lie in the street and let the cherry blossoms bury you. If you wanted.

* * *

>fly
(getting out of the cherry blossom trees)
You are already flying.

>l
Blossom Street (in the sky)
A street stretches in front of you. You don't know this street, but it exists. Above you, and all around you, are cherry blossoms: they fill the street gutter; they overflow onto a yellow stripe of paint; they enter your nose, and come out your ears.

You see grass to the left. To the right is a yellow stripe, a streetlight, and a fence.

You could sit here if you wanted. You could run and dance on that yellow stripe. You could lie in the street and let the cherry blossoms bury you. If you wanted.

>climb frence
You can't see any such thing.

>climb fence
(getting out of the sky)
You hoist yourself to the top of the fence.

You are now seated on the fence. You stare at your toes, and wonder how they got there.

>fly
(getting off the fence)
You are already flying.

* * *

>fly
You are now flying in the sky. Like the fastest things on earth.

>climb trees
(getting out of the sky)
You grab a branch and swing yourself up, into the midst of the blossoms. Kind of like being in a snowglobe.

You are now seated in the cherry blossom trees. You lean back on your hands.

>fly
(getting out of the cherry blossom trees)
You are now flying in the sky. A beam of sunlight crosses in front of you.

>fly in trees
You are now flying in the sky. Like the fastest things on earth.

>l
Blossom Street (in the sky)
A street stretches in front of you. You don't know this street, but it exists. Above you, and all around you, are cherry blossoms: they fill the street gutter; they overflow onto a yellow stripe of paint; they enter your nose, and come out your ears.

You see grass to the left. To the right is a yellow stripe, a streetlight, and a fence.

You could sit here if you wanted. You could run and dance on that yellow stripe. You could lie in the street and let the cherry blossoms bury you. If you wanted.

>fly
You are already flying.

* * *

>fly
(getting out of the cherry blossom trees)
You are now flying in the sky. A beam of sunlight crosses in front of you.

>l
Blossom Street (in the sky)
A street stretches in front of you. You don't know this street, but it exists. Above you, and all around you, are cherry blossoms: they fill the street gutter; they overflow onto a yellow stripe of paint; they enter your nose, and come out your ears.

You see grass to the left. To the right is a yellow stripe, a streetlight, and a fence.

You could sit here if you wanted. You could run and dance on that yellow stripe. You could lie in the street and let the cherry blossoms bury you. If you wanted.

>go east
You'll have to get out of the sky first.

>east
You'll have to get out of the sky first.

>climb tree
(getting out of the sky)
You grab a branch and swing yourself up, into the midst of the blossoms. Kind of like being in a snowglobe.

You are now seated in the cherry blossom trees. You feel a pebble beneath your buttock.

>east
You'll have to get out of the cherry blossom trees first.

>get out
You get out of the cherry blossom trees.

Blossom Street

>climb tree
You grab a branch and swing yourself up, into the midst of the blossoms. Kind of like being in a snowglobe.

You are now seated in the cherry blossom trees. You rest your chin on your upraised knees.

>get down
You get out of the cherry blossom trees.

Blossom Street

>fly east
I only understood you as far as wanting to fly.

* * *

>fly
You are now flying in the sky. Like the fastest things on earth.

>fly
You are now flying in the sky. You go high, and then glide slowly towards the earth.

>fly
You are now flying in the sky. Like a bird.

>fly
You are now flying in the sky. You hit a hot air patch and shoot upwards geyser style.

>fly
You are now flying in the sky. You feel millions of Nitrogen and Oxygen particles hitting your skin.

>x particles
You can't see the particles, but you can feel them.

>taste particles
Pretty much what you would expect.

>hug tree
You can only do that to something animate.

>n
(first leaving the sky)

Maisan Mountain
After traveling north for some time you find yourself atop Maisain Mountain, looking out over the farmland of North Jeolla. There's a golf course down there that you might just be able to touch, as well some man-made lakes and Geum River, winding itself towards the Yellow Sea.

You could dance in the sky here, if you wanted. You could probably fly.

>n
Napo Field
You fly north until you can fly no more. Then you land here, in a middle school soccer field.

The air is cool and crisp to the touch. Autumn has come, and the birds will be here soon, stopping in this field on their way south. Or maybe they've already been.

There are some parallel bars in the distance. You could swing from those bars, or climb that barren tree. Or you could just keep going north.

* * *

>n
A Stream
You run far this time, and come upon a stream where a father plays with his two daughters.

>hug girls
Keep your mind on the game.

>hug man
Keep your mind on the game.

>kiss girls
Keep your mind on the game.

>touch girls
They probably wouldn't appreciate that.

>hug girls
Keep your mind on the game.

>caress girls
That's not a verb I recognize.

>carress girls
That's not a verb I recognize.

>smooch girls
That's not a verb I recognize.

>n
Sandlot
You follow the stream, walking north, until the stream becomes a river and you can no longer touch the bottom. Then you float with your eyes closed, until the river washes you up on an asphalt shore, where two boys play baseball at dusk.

You feel your time is drawing short. You won't be able to stay here long.

* * *

>n
Leaving
You're flying now, faster than you've ever flown before... the air that streams by you feels like a thick liquid. Glancing over your shoulder, your last glimpse of Korea is a girl in red stripes, holding an umbrella.

And then she's gone.

>s
Being There. A notgame for Korea, created by Jordan Magnuson.

                                       NecessaryGames.com

* * *

>fly
You are now flying in the sky. Like the fastest things on earth.

>land
You get out of the sky.

Blossom Street
A street stretches in front of you. You don't know this street, but it exists. Above you, and all around you, are cherry blossoms: they fill the street gutter; they overflow onto a yellow stripe of paint; they enter your nose, and come out your ears.

You see grass to the left. To the right is a yellow stripe, a streetlight, and a fence.

You could sit here if you wanted. You could run and dance on that yellow stripe. You could lie in the street and let the cherry blossoms bury you. If you wanted.

* * *

>fly
You are now flying in the sky. Like the fastest things on earth.

>dive
You soar up, and then down, twirling and gliding like you were born to do it.

>dive
You soar up, and then down, twirling and gliding like you were born to do it. Like a bird.

>sit down
You can't take that position in the sky.

>sit on road
(getting out of the sky)
You are now seated on the road. Well, doing more of a squat, really.

>dive
You plunge deep into the water, surrounding yourself with the cool liquid until you can hold your breath no more, then you surface again. It feels like you've been here before.

>fly
(getting off the road)
You are now flying in the sky. You hit a hot air patch and shoot upwards geyser style.

>dive
You soar up, and then down, twirling and gliding like you were born to do it. Slowly, lazily, just for fun.

>stand
You can't take that position in the sky.

>stand on street
(getting out of the sky)
You are now standing on the road.

>fly
(getting off the road)
You are now flying in the sky.

>dive
You soar up, and then down, twirling and gliding like you were born to do it. You feel millions of Nitrogen and Oxygen particles hitting your skin.

>dive
You soar up, and then down, twirling and gliding like you were born to do it. Like a plane.

>dive
You soar up, and then down, twirling and gliding like you were born to do it. You go high, and then glide slowly towards the earth.

>dive
You soar up, and then down, twirling and gliding like you were born to do it. Like the fastest things on earth.

>dive
You soar up, and then down, twirling and gliding like you were born to do it.

>dive
You soar up, and then down, twirling and gliding like you were born to do it.

>n
(first leaving the sky)

Maisan Mountain
After traveling north for some time you find yourself atop Maisain Mountain, looking out over the farmland of North Jeolla. There's a golf course down there that you might just be able to touch, as well as some man-made lakes and Geum River, winding itself towards the Yellow Sea.

You could dance in the sky here, if you wanted. You could probably fly.

>swim
What do you want to swim in?

* * *

>l
Maisan Mountain (in Geum River)
Maisain Mountain, looking out over the farmland of North Jeolla. There's a golf course down there that you might just be able to touch, as well as some man-made lakes and Geum River, winding itself towards the Yellow Sea.

You could dance in the sky here, if you wanted. You could probably fly.

>dive
You plunge deep into the water, surrounding yourself with the cool liquid until you can hold your breath no more, then you surface again.

>swim
What do you want to swim in?

>lake
(getting out of Geum River)
You jump into a lake. Cool water flows over you.

>l
Maisan Mountain (in the man-made lakes)
Maisain Mountain, looking out over the farmland of North Jeolla. There's a golf course down there that you might just be able to touch, as well as some man-made lakes and Geum River, winding itself towards the Yellow Sea.

You could dance in the sky here, if you wanted. You could probably fly.

>swim
What do you want to swim in?

>lake
You swim around some more.

>dive
You plunge deep into the water, surrounding yourself with the cool liquid until you can hold your breath no more, then you surface again. You take a deep breath.

>fly
(getting out of the man-made lakes)
You are now flying in the sky. You close your eyes, but the world is still there, in front of you.

>fly
You are now flying in the sky. Above you is the sky.

>fly
You are now flying in the sky. Like a bird.

* * *

>fly
You are now flying in the sky. You hit a hot air patch and shoot upwards geyser style.

>fly
You are now flying in the sky.

>dive
You soar up, and then down, twirling and gliding like you were born to do it. Slowly, lazily, just for fun.

>swim in lake
(getting out of the sky)
You jump into a lake. Cool water flows over you.

>dive
You plunge deep into the water, surrounding yourself with the cool liquid until you can hold your breath no more, then you surface again. You hear rain in the distance.

* * *

Blossom Street
A street stretches in front of you. You don't know this street, but it exists. Above you, and all around you, are cherry blossoms: they fill the street gutter; they overflow onto a yellow stripe of paint; they enter your nose, and come out your ears.

You see grass to the left. To the right is a yellow stripe, a streetlight, and a fence.

You could sit here if you wanted. You could run and dance on that yellow stripe. You could lie in the street and let the cherry blossoms bury you. If you wanted.

>dance in the sky
You are now dancing in the sky. You spin and you spin, until you can't see straight.

* * *

Blossom Street
A street stretches in front of you. You don't know this street, but it exists. Above you, and all around you, are cherry blossoms: they fill the street gutter; they overflow onto a yellow stripe of paint; they enter your nose, and come out your ears.

You see grass to the left. To the right is a yellow stripe, a streetlight, and a fence.

You could sit here if you wanted. You could run and dance on that yellow stripe. You could lie in the street and let the cherry blossoms bury you. If you wanted.

>fly in sky
You are now flying in the sky. You feel a breeze behind you.

>d
You get out of the sky.

Blossom Street
A street stretches in front of you. You don't know this street, but it exists. Above you, and all around you, are cherry blossoms: they fill the street gutter; they overflow onto a yellow stripe of paint; they enter your nose, and come out your ears.

You see grass to the left. To the right is a yellow stripe, a streetlight, and a fence.

You could sit here if you wanted. You could run and dance on that yellow stripe. You could lie in the street and let the cherry blossoms bury you. If you wanted.

You lower yourself down, getting as close as you can to the earth.

>d
But you aren't in anything at the moment.

You lower yourself down, getting as close as you can to the earth.

>d
But you aren't in anything at the moment.

* * *

>d
But you aren't in anything at the moment.

You lower yourself down, getting as close as you can to the earth.

>fly in sky
You are now flying in the sky. You feel millions of Nitrogen and Oxygen particles hitting your skin.

>d
You get out of the sky.

Blossom Street
A street stretches in front of you. You don't know this street, but it exists. Above you, and all around you, are cherry blossoms: they fill the street gutter; they overflow onto a yellow stripe of paint; they enter your nose, and come out your ears.

You see grass to the left. To the right is a yellow stripe, a streetlight, and a fence.

You could sit here if you wanted. You could run and dance on that yellow stripe. You could lie in the street and let the cherry blossoms bury you. If you wanted.

You lower yourself down, getting as close as you can to the earth.

* * *

>d
But you aren't in anything at the moment.

You lower yourself down, getting as close as you can to the earth.

>n
Maisan Mountain
After traveling north for some time you find yourself atop Maisain Mountain, looking out over the farmland of North Jeolla. There's a golf course down there that you might just be able to touch, as well some man-made lakes and Geum River, winding itself towards the Yellow Sea.

You could dance in the sky here, if you wanted. You could probably fly.

* * *

>n
Napo Field
You fly north until you can fly no more. Then you land here, in a middle school soccer field.

The air is cool and crisp to the touch. Autumn has come, and the birds will be here soon, stopping in this field on their way south. Or maybe they've already been.

There are some parallel bars in the distance. You could swing from those bars, or climb that barren tree. Or you could just keep going north.

>n
Temple Spring
You wander north for hours, searching for you don't know what. And then you find it: a fresh spring at the temple of the nirvana fish, spouting clean, cold water from a bamboo chute.

The water flows onto a stone platform, then over the edge, and away.

>dance in water
That's not something you can enter.

>dance on water
That's not something you can enter.

>dance on platform
You are now dancing on the stone platform. You spin and you spin, until you can't see straight.

>dance on edge
You can't see any such thing.

>walk on platform
You are now walking on the stone platform.

>run on platform
You are now running on the stone platform. Around and around in circles.

>fly
You can't take that position on the stone platform.

>fly in sky
(getting off the stone platform)
You are now flying in the sky. Like a bird.

>d
You get out of the sky.

Temple Spring
You wander north for hours, searching for you don't know what. And then you find it: a fresh spring at the temple of the nirvana fish, spouting clean, cold water from a bamboo chute.

The water flows onto a stone platform, then over the edge, and away.

You lower yourself down, getting as close as you can to the earth.

>fly
You are now flying. Like a plane.

>l
Temple Spring
You wander north for hours, searching for you don't know what. And then you find it: a fresh spring at the temple of the nirvana fish, spouting clean, cold water from a bamboo chute.

The water flows onto a stone platform, then over the edge, and away.

>d
But you aren't in anything at the moment.

You lower yourself down, getting as close as you can to the earth.

* * *

Blossom Street
A street stretches in front of you. You don't know this street, but it exists. Above you, and all around you, are cherry blossoms: they fill the street gutter; they overflow onto a yellow stripe of paint; they enter your nose, and come out your ears.

You see grass to the left. To the right is a yellow stripe, a streetlight, and a fence.

You could sit here if you wanted. You could run and dance on that yellow stripe. You could lie in the street and let the cherry blossoms bury you. If you wanted.

>fill street
That's hardly portable.

* * *

Blossom Street
A street stretches in front of you. You don't know this street, but it exists. Above you, and all around you, are cherry blossoms: they fill the street gutter; they overflow onto a yellow stripe of paint; they enter your nose, and come out your ears.

You see grass to the left. To the right is a yellow stripe, a streetlight, and a fence.

You could sit here if you wanted. You could run and dance on that yellow stripe. You could lie in the street and let the cherry blossoms bury you. If you wanted.

>sing
You are now singing. No one to say if you're any good or not.

>sing
You are already singing.

>dance
You are now dancing.

>sing
You are now singing. A trumpet sounds in the distance.

>dance
You are now dancing. A contemporary interpretation of the scenery around you.

>sing
You are now singing.

>dance
You are now dancing. The earth spins slowly.

>sing
You are now singing. For the world at large.

>dance
You are now dancing. Tapping away like a mad person.

>sing
You are now singing.

>dance
You are now dancing.

>sing
You are now singing. Tiny drums in your ears vibrate in time.

* * *

Blossom Street
A street stretches in front of you. You don't know this street, but it exists. Above you, and all around you, are cherry blossoms: they fill the street gutter; they overflow onto a yellow stripe of paint; they enter your nose, and come out your ears.

You see grass to the left. To the right is a yellow stripe, a streetlight, and a fence.

You could sit here if you wanted. You could run and dance on that yellow stripe. You could lie in the street and let the cherry blossoms bury you. If you wanted.

>play
Please be more specific about what you'd like to do.

>n
Maisan Mountain
After traveling north for some time you find yourself atop Maisain Mountain, looking out over the farmland of North Jeolla. There's a golf course down there that you might just be able to touch, as well some man-made lakes and Geum River, winding itself towards the Yellow Sea.

You could dance in the sky here, if you wanted. You could probably fly.

* * *

>n
Temple Spring
You wander north for hours, searching for you don't know what. And then you find it: A fresh spring at the temple of the nirvana fish, spouting clean, cold water from a bamboo chute.

The water flows onto a stone platform, then over the edge, and away.

>play
Please be more specific about what you'd like to do.

>n
Kimchi Pots
Walking north you come upon some gaint Kimchi pots.

If there was kimchi in one of those pots you could eat it... you could put it in your mouth and let the spices soak your tongue.

You could climb into one of the pots and sing until your voice was hoarse.

You could stand on top of one of them and jump up and down until someone made you stop.

You could do a million things. Or nothing at all.

>play
Please be more specific about what you'd like to do.

>n
A Stream
You run far this time, and come upon a stream where a father plays with his two daughters.

>play
You summon your strength and produce a monstrous splash.

>n
Sandlot
You follow the stream, walking north, until the stream becomes a river and you can no longer touch the bottom. Then you float with your eyes closed, until the river washes you up on an asphalt shore, where two boys play baseball at dusk.

You feel your time is drawing short. You won't be able to stay here long.

>play
Through pantomime you demonstrate to the boys that you are an exceptional baseball player. They gladly let you join in, and you play for some time.

>n
A Group of Boys
You make your way quickly north, but a group of smiling boys jumps in front of you.

"Kimchi! My name is Bae! Hello! I love you! My name is Chin-ho!"

>play
Please be more specific about what you'd like to do.

* * *

Blossom Street
A street stretches in front of you. You don't know this street, but it exists. Above you, and all around you, are cherry blossoms: they fill the street gutter; they overflow onto a yellow stripe of paint; they enter your nose, and come out your ears.

You see grass to the left. To the right is a yellow stripe, a streetlight, and a fence.

You could sit here if you wanted. You could run and dance on that yellow stripe. You could lie in the street and let the cherry blossoms bury you. If you wanted.

>fly east
Maisan Mountain
After traveling east for some time you find yourself atop Maisain Mountain, looking out over the farmland of North Jeolla. There's a golf course down there that you might just be able to touch, as well some man-made lakes and Geum River, winding itself towards the Yellow Sea.

You could dance in the sky here, if you wanted. You could probably fly.

>climb tree
You climb up a tree for an even better view.

You are now seated in the trees. Well, doing more of a squat, really.

>l
Maisan Mountain (in the trees)
Maisain Mountain, looking out over the farmland of North Jeolla. There's a golf course down there that you might just be able to touch, as well some man-made lakes and Geum River, winding itself towards the Yellow Sea.

You could dance in the sky here, if you wanted. You could probably fly.

>fly north
I only understood you as far as wanting to fly.

>fly east
(first leaving the trees)

Napo Field
You fly north until you can fly no more. Then you land here, in a middle school soccer field.

The air is cool and crisp to the touch. Autumn has come, and the birds will be here soon, stopping in this field on their way south. Or maybe they've already been.

There are some parallel bars in the distance. You could swing from those bars, or climb that barren tree. Or you could just keep going north.

>l
Napo Field
The air is cool and crisp to the touch. Autumn has come, and the birds will be here soon, stopping in this field on their way south. Or maybe they've already been.

There are some parallel bars in the distance. You could swing from those bars, or climb that barren tree. Or you could just keep going north.

* * *

>fly east
Maisan Mountain
After traveling east for some time you find yourself atop Maisain Mountain, looking out over the farmland of North Jeolla. There's a golf course down there that you might just be able to touch, as well some man-made lakes and Geum River, winding itself towards the Yellow Sea.

You could dance in the sky here, if you wanted. You could probably fly.

>fly west
Napo Field
You fly west until you can fly no more. Then you land here, in a middle school soccer field.

The air is cool and crisp to the touch. Autumn has come, and the birds will be here soon, stopping in this field on their way south. Or maybe they've already been.

There are some parallel bars in the distance. You could swing from those bars, or climb that barren tree. Or you could just keep going west.

>walk south
Temple Spring
You wander south for hours, searching for you don't know what. And then you find it: A fresh spring at the temple of the nirvana fish, spouting clean, cold water from a bamboo chute.

The water flows onto a stone platform, then over the edge, and away.

>swim norht
I didn't understand that sentence.

>swim north
Kimchi Pots
Walking north you come upon some gaint Kimchi pots.

If there was kimchi in one of those pots you could eat it... you could put it in your mouth and let the spices soak your tongue.

You could climb into one of the pots and sing until your voice was hoarse.

You could stand on top of one of them and jump up and down until someone made you stop.

You could do a million things. Or nothing at all.

>open pot
You open a kimchi pot, revealing more kimchi than you know what to do with.

>climb into pot
You get into the open kimchi pot.

In the open kimchi pot you can see a small mountain of kimchi.

>get out
You get out of the open kimchi pot.

Kimchi Pots
If there was kimchi in one of those pots you could eat it... you could put it in your mouth and let the spices soak your tongue.

You could climb into one of the pots and sing until your voice was hoarse.

You could stand on top of one of them and jump up and down until someone made you stop.

You could do a million things. Or nothing at all.

>climb into kimchi pot
You get into the open kimchi pot.

In the open kimchi pot you can see a small mountain of kimchi.

>get into pot
But you're already in the open kimchi pot.

>laugh
That's not a verb I recognize.

* * *

Blossom Street
A street stretches in front of you. You don't know this street, but it exists. Above you, and all around you, are cherry blossoms: they fill the street gutter; they overflow onto a yellow stripe of paint; they enter your nose, and come out your ears.

You see grass to the left. To the right is a yellow stripe, a streetlight, and a fence.

You could sit here if you wanted. You could run and dance on that yellow stripe. You could lie in the street and let the cherry blossoms bury you. If you wanted.

>walk east
*** Run-time problem P39: Attempt to say a snippet value which is currently invalid: words 0 to 0.

I only understood you as far as wanting to walk.

* * *

Blossom Street
A street stretches in front of you. You don't know this street, but it exists. Above you, and all around you, are cherry blossoms: they fill the street gutter; they overflow onto a yellow stripe of paint; they enter your nose, and come out your ears.

You see grass to the left. To the right is a yellow stripe, a streetlight, and a fence.

You could sit here if you wanted. You could run and dance on that yellow stripe. You could lie in the street and let the cherry blossoms bury you. If you wanted.

>laugh
You laugh out loud.

>giggle
You laugh out loud.

>fly
You are now flying in the sky. It feels like you've been here before.

>fly
You are now flying in the sky. You take a deep breath.

>fly
You are now flying in the sky. Like a plane.

>fly
You are now flying in the sky. Like a bird.

>fly
You are now flying in the sky. Like the fastest things on earth.

>fly
You are now flying in the sky. You feel millions of Nitrogen and Oxygen particles hitting your skin.

* * *

Blossom Street
A street stretches in front of you. You don't know this street, but it exists. Above you, and all around you, are cherry blossoms: they fill the street gutter; they overflow onto a yellow stripe of paint; they enter your nose, and come out your ears.

You see grass to the left. To the right is a yellow stripe, a streetlight, and a fence.

You could sit here if you wanted. You could run and dance on that yellow stripe. You could lie in the street and let the cherry blossoms bury you. If you wanted.

>smile
You smile to yourself. The breeze ruffles your hair.

>smile
You smile, up into the sky.

>smile
You smile, up into the sky.

>laugh
You laugh out loud.

>laugh
You laugh out loud.The ether shifts around you.

* * *

>smile
You smile to yourself. The breeze ruffles your hair.

>smil
That's not a verb I recognize.

>smile
You smile, up into the sky.
Life is good.

>smile
You smile, up into the sky.
You take a deep breath.

>dance
You are now dancing. This would probably be called a sword dance, if you had a sword.

>dance
You are already dancing.

>smile
You smile, up into the sky.
Above you is the sky.

* * *

Blossom Street
A street stretches in front of you. You don't know this street, but it exists. Above you, and all around you, are cherry blossoms: they fill the street gutter; they overflow onto a yellow stripe of paint; they enter your nose, and come out your ears.

You see grass to the left. To the right is a yellow stripe, a streetlight, and a fence.

You could sit here if you wanted. You could run and dance on that yellow stripe. You could lie in the street and let the cherry blossoms bury you. If you wanted.

>lie in road
You lie down on your back in the middle of the street, and open your mouth. Cherry blossoms rain down like snow, and settle on your legs, your torso, your fingertips.

You are now reclining on the road. Arms outstretched.

>l
Blossom Street (on the road)
A street stretches in front of you. You don't know this street, but it exists. Above you, and all around you, are cherry blossoms: they fill the street gutter; they overflow onto a yellow stripe of paint; they enter your nose, and come out your ears.

You see grass to the left. To the right is a yellow stripe, a streetlight, and a fence.

You could sit here if you wanted. You could run and dance on that yellow stripe. You could lie in the street and let the cherry blossoms bury you. If you wanted.

* * *

Blossom Street
A street stretches in front of you. You don't know this street, but it exists. Above you, and all around you, are cherry blossoms: they fill the street gutter; they overflow onto a yellow stripe of paint; they enter your nose, and come out your ears.

You see grass to the left. To the right is a yellow stripe, a streetlight, and a fence.

You could sit here if you wanted. You could run and dance on that yellow stripe. You could lie in the street and let the cherry blossoms bury you. If you wanted.

>lie in the road
You lie down on your back in the middle of the street, and open your mouth. Cherry blossoms rain down like snow, and settle on your legs, your torso, your fingertips.

>l
Blossom Street (on the road)
A street stretches in front of you. You don't know this street, but it exists. Above you, and all around you, are cherry blossoms: they fill the street gutter; they overflow onto a yellow stripe of paint; they enter your nose, and come out your ears.

You see grass to the left. To the right is a yellow stripe, a streetlight, and a fence.

You could sit here if you wanted. You could run and dance on that yellow stripe. You could lie in the street and let the cherry blossoms bury you. If you wanted.

>sit on grass
(getting off the road)
You are now seated on the grass. You rest your chin on your upraised knees.

>lie in road
(getting off the grass)
You lie down on your back in the middle of the street, and open your mouth. Cherry blossoms rain down like snow, and settle on your legs, your torso, your fingertips.

* * *

Blossom Street
A street stretches in front of you. You don't know this street, but it exists. Above you, and all around you, are cherry blossoms: they fill the street gutter; they overflow onto a yellow stripe of paint; they enter your nose, and come out your ears.

You see grass to the left. To the right is a yellow stripe, a streetlight, and a fence.

You could sit here if you wanted. You could run and dance on that yellow stripe. You could lie in the street and let the cherry blossoms bury you. If you wanted.

>x sky
As you peer at the sky it seems to dance.

* * *

Blossom Street
A street stretches in front of you. You don't know this street, but it exists. Above you, and all around you, are cherry blossoms: they fill the street gutter; they overflow onto a yellow stripe of paint; they enter your nose, and come out your ears.

You see grass to the left. To the right is a yellow stripe, a streetlight, and a fence.

You could sit here if you wanted. You could run and dance on that yellow stripe. You could lie in the street and let the cherry blossoms bury you. If you wanted.

>cry
For some reason, tears drip down your face.

>cry
For some reason, tears drip down your face. Above you is the sky.

>cry
For some reason, tears drip down your face. The breeze ruffles your hair.

* * *

Blossom Street
A street stretches in front of you. You don't know this street, but it exists. Above you, and all around you, are cherry blossoms: they fill the street gutter; they overflow onto a yellow stripe of paint; they enter your nose, and come out your ears.

You see grass to the left. To the right is a yellow stripe, a streetlight, and a fence.

You could sit here if you wanted. You could run and dance on that yellow stripe. You could lie in the street and let the cherry blossoms bury you. If you wanted.

>breathe
You breathe in deeply, then let it out slowly.

>breathe
You breathe in deeply, then let it out slowly. A bird flies by, and looks at you.

>climb tree
You grab a branch and swing yourself up, into the midst of the blossoms. Kind of like being in a snowglobe.

You are now seated in the cherry blossom trees. Well, doing more of a squat, really.

>get down
You get out of the cherry blossom trees.

Blossom Street
A street stretches in front of you. You don't know this street, but it exists. Above you, and all around you, are cherry blossoms: they fill the street gutter; they overflow onto a yellow stripe of paint; they enter your nose, and come out your ears.

You see grass to the left. To the right is a yellow stripe, a streetlight, and a fence.

You could sit here if you wanted. You could run and dance on that yellow stripe. You could lie in the street and let the cherry blossoms bury you. If you wanted.

>climb tree
You grab a branch and swing yourself up, into the midst of the blossoms. Kind of like being in a snowglobe.

You are now seated in the cherry blossom trees. Cross-legged.

>jump down
I only understood the first part of that-- trying anyway.

(retrying as if you'd typed "jump.")
You jump on the spot. Above you is the sky.

* * *

Blossom Street
A street stretches in front of you. You don't know this street, but it exists. Above you, and all around you, are cherry blossoms: they fill the street gutter; they overflow onto a yellow stripe of paint; they enter your nose, and come out your ears.

You see grass to the left. To the right is a yellow stripe, a streetlight, and a fence.

You could sit here if you wanted. You could run and dance on that yellow stripe. You could lie in the street and let the cherry blossoms bury you. If you wanted.

>pray
You pray, silently.

>say prayer
You pray, silently. You take a deep breath.

>climb inside tree
I only understood the first part of that-- trying anyway.

(retrying as if you'd typed "climb inside.")
You must name something more substantial.

>climb into tree
You grab a branch and swing yourself up, into the midst of the blossoms. Kind of like being in a snowglobe.

You get into the cherry blossom trees.

* * *

Blossom Street
A street stretches in front of you. You don't know this street, but it exists. Above you, and all around you, are cherry blossoms: they fill the street gutter; they overflow onto a yellow stripe of paint; they enter your nose, and come out your ears.

You see grass to the left. To the right is a yellow stripe, a streetlight, and a fence.

You could sit here if you wanted. You could run and dance on that yellow stripe. You could lie in the street and let the cherry blossoms bury you. If you wanted.

>clim inside tree
That's not a verb I recognize.

>climb inside tree
You must supply a noun.

>climb inside tree
You must supply a noun.

* * *

Blossom Street
A street stretches in front of you. You don't know this street, but it exists. Above you, and all around you, are cherry blossoms: they fill the street gutter; they overflow onto a yellow stripe of paint; they enter your nose, and come out your ears.

You see grass to the left. To the right is a yellow stripe, a streetlight, and a fence.

You could sit here if you wanted. You could run and dance on that yellow stripe. You could lie in the street and let the cherry blossoms bury you. If you wanted.

>climb inside tree
You grab a branch and swing yourself up, into the midst of the blossoms. Kind of like being in a snowglobe.

You get into the cherry blossom trees.

>n
(first leaving the cherry blossom trees)

Maisan Mountain
After traveling north for some time you find yourself atop Maisain Mountain, looking out over the farmland of North Jeolla. There's a golf course down there that you might just be able to touch, as well some man-made lakes and Geum River, winding itself towards the Yellow Sea.

You could dance in the sky here, if you wanted. You could probably fly.

>n
Napo Field
You fly north until you can fly no more. Then you land here, in a middle school soccer field.

The air is cool and crisp to the touch. Autumn has come, and the birds will be here soon, stopping in this field on their way south. Or maybe they've already been.

There are some parallel bars in the distance. You could swing from those bars, or climb that barren tree. Or you could just keep going north.

* * *

>n
Kimchi Pots
Walking north you come upon some gaint Kimchi pots.

If there was kimchi in one of those pots you could eat it... you could put it in your mouth and let the spices soak your tongue.

You could climb into one of the pots and sing until your voice was hoarse.

You could stand on top of one of them and jump up and down until someone made you stop.

You could do a million things. Or nothing at all.

>climb inside pot
You'll need to open one of the pots first.

>open pot
You open a kimchi pot, revealing more kimchi than you know what to do with.

>climb inside
You must name something more substantial.

>climb inside pot
You get into the open kimchi pot.

In the open kimchi pot you can see a small mountain of kimchi.

>deat it all
That's not a verb I recognize.

>eat it all
I only understood the first part of that-- trying anyway.

(retrying as if you'd typed "eat it.")
You take a bite of the kimchi. Spicy and delicious.

* * *

Blossom Street
A street stretches in front of you. You don't know this street, but it exists. Above you, and all around you, are cherry blossoms: they fill the street gutter; they overflow onto a yellow stripe of paint; they enter your nose, and come out your ears.

You see grass to the left. To the right is a yellow stripe, a streetlight, and a fence.

You could sit here if you wanted. You could run and dance on that yellow stripe. You could lie in the street and let the cherry blossoms bury you. If you wanted.

>shout
You open your mouth, and let out everything inside of you. The earth spins slowly.

>yell
You open your mouth, and let out everything inside of you.

>n
Maisan Mountain
After traveling north for some time you find yourself atop Maisain Mountain, looking out over the farmland of North Jeolla. There's a golf course down there that you might just be able to touch, as well some man-made lakes and Geum River, winding itself towards the Yellow Sea.

You could dance in the sky here, if you wanted. You could probably fly.

* * *

>n
A Stream
You run far this time, and come upon a stream where a father plays with his two daughters.

>shout to father
I only understood you as far as wanting to shout.

>shout to man
I only understood you as far as wanting to shout.

>shout
You open your mouth, and let out everything inside of you. Life is good.

* * *

Blossom Street
A street stretches in front of you. You don't know this street, but it exists. Above you, and all around you, are cherry blossoms: they fill the street gutter; they overflow onto a yellow stripe of paint; they enter your nose, and come out your ears.

You see grass to the left. To the right is a yellow stripe, a streetlight, and a fence.

You could sit here if you wanted. You could run and dance on that yellow stripe. You could lie in the street and let the cherry blossoms bury you. If you wanted.

>leave
Maisan Mountain
After traveling east for some time you find yourself atop Maisain Mountain, looking out over the farmland of North Jeolla. There's a golf course down there that you might just be able to touch, as well some man-made lakes and Geum River, winding itself towards the Yellow Sea.

You could dance in the sky here, if you wanted. You could probably fly.

>leave
Napo Field
You fly west until you can fly no more. Then you land here, in a middle school soccer field.

The air is cool and crisp to the touch. Autumn has come, and the birds will be here soon, stopping in this field on their way south. Or maybe they've already been.

There are some parallel bars in the distance. You could swing from those bars, or climb that barren tree. Or you could just keep going west.

>leave
Temple Spring
You wander north for hours, searching for you don't know what. And then you find it: A fresh spring at the temple of the nirvana fish, spouting clean, cold water from a bamboo chute.

The water flows onto a stone platform, then over the edge, and away.

>leave
Kimchi Pots
Walking south you come upon some gaint Kimchi pots.

If there was kimchi in one of those pots you could eat it... you could put it in your mouth and let the spices soak your tongue.

You could climb into one of the pots and sing until your voice was hoarse.

You could stand on top of one of them and jump up and down until someone made you stop.

You could do a million things. Or nothing at all.

>leave
A Stream
You run far this time, and come upon a stream where a father plays with his two daughters.

* * *

>leave
Kimchi Pots
Walking south you come upon some gaint Kimchi pots.

If there was kimchi in one of those pots you could eat it... you could put it in your mouth and let the spices soak your tongue.

You could climb into one of the pots and sing until your voice was hoarse.

You could stand on top of one of them and jump up and down until someone made you stop.

You could do a million things. Or nothing at all.

>open pot
You open a kimchi pot, revealing more kimchi than you know what to do with.

>get inside pot
You get into the open kimchi pot.

In the open kimchi pot you can see a small mountain of kimchi.

>close pot
You close the open kimchi pot.

It is now pitch dark in here!

>leave
A Stream
You run far this time, and come upon a stream where a father plays with his two daughters.

A Stream
A stream where a father plays with his two daughters.

>jump in water
You can't take that position in the stream.

* * *

Blossom Street
A street stretches in front of you. You don't know this street, but it exists. Above you, and all around you, are cherry blossoms: they fill the street gutter; they overflow onto a yellow stripe of paint; they enter your nose, and come out your ears.

You see grass to the left. To the right is a yellow stripe, a streetlight, and a fence.

You could sit here if you wanted. You could run and dance on that yellow stripe. You could lie in the street and let the cherry blossoms bury you. If you wanted.

>showme it
streetlight - spot
location: in Blossom Street
unlit; inedible; fixed in place; scenery; singular-named; improper-named; neuter; ordinarily enumerated; seen; unfamiliar; unswingable; not-one-of-many; not drinkable; weak_smelling; soft_sounding
description: It's used to light the way for pedestrians out after dark.
printed name: streetlight
printed plural name: spots
feeling: The pole is metal, the lamp cover is hard plastic.
flavor: That's one way to get your body's daily dose of metals.
odor: normal
sound: no buzzing, no flickering... just silence
enterable
carrying capacity: 100
posture: standing

>n
Maisan Mountain
After traveling north for some time you find yourself atop Maisain Mountain, looking out over the farmland of North Jeolla. There's a golf course down there that you might just be able to touch, as well as some man-made lakes and Geum River, winding itself towards the Yellow Sea.

You could dance in the sky here, if you wanted. You could probably fly.

* * *

>n
Temple Spring
You wander north for hours, searching for you don't know what. And then you find it: A fresh spring at the temple of the nirvana fish, spouting clean, cold water from a bamboo chute.

The water flows onto a stone platform, then over the edge, and away.

>showme it
rocks - thing
location: in Temple Spring
unlit; inedible; fixed in place; scenery; singular-named; improper-named; neuter; ordinarily enumerated; seen; unfamiliar; unswingable; not-one-of-many; not drinkable; weak_smelling; soft_sounding
description: The rocks here are overgrown with moss and vines, like all good rocks should be.
printed name: rocks
feeling: You run your hand over the rock, fingers passing from hard stone to soft moss and back.
flavor: The moss that covers the rocks provides an earthy, mossy flavor.
odor: damp rock
sound: a running stream

>n
Kimchi Pots
Walking north you come upon some gaint Kimchi pots.

If there was kimchi in one of those pots you could eat it... you could put it in your mouth and let the spices soak your tongue.

You could climb into one of the pots and sing until your voice was hoarse.

You could stand on top of one of them and jump up and down until someone made you stop.

You could do a million things. Or nothing at all.

* * *

>showme it
closed kimchi pot - spot
location: in Kimchi Pots
unlit; inedible; fixed in place; scenery; singular-named; improper-named; neuter; ordinarily enumerated; seen; unfamiliar; unswingable; one-of-many; not drinkable; weak_smelling; soft_sounding
printed name: closed kimchi pot
indefinite article: a
printed plural name: spots
feeling: The pots are glazed, and feel smooth and curvy.
flavor: The pots themselves don't taste like much.
odor: strongly spiced cabbage
sound: pots full of cabbage
enterable
carrying capacity: 100
posture: standing

>open pot
You open a kimchi pot, revealing more kimchi than you know what to do with.

* * *

>eat it
Pretty much what you would expect.

>eat kimchi
You take a bite of the kimchi. Spicy and delicious.

>eat it
You take another bite.

* * *

I beg your pardon?

>n
Maisan Mountain
After traveling north for some time you find yourself atop Maisain Mountain, looking out over the farmland of North Jeolla. There's a golf course down there that you might just be able to touch, as well as some man-made lakes and Geum River, winding itself towards the Yellow Sea.

You could dance in the sky here, if you wanted. You could probably fly.

* * *

>n
Kimchi Pots
Walking north you come upon some gaint Kimchi pots.

If there was kimchi in one of those pots you could eat it... you could put it in your mouth and let the spices soak your tongue.

You could climb into one of the pots and sing until your voice was hoarse.

You could stand on top of one of them and jump up and down until someone made you stop.

You could do a million things. Or nothing at all.

>taste it
The pots themselves don't taste like much.

>eat it
You'll need to open a pot first (and hope that the kimchi is actually in there).

* * *

>showme it
open kimchi pot - open container
    kimchi - kimchi food
location: in Kimchi Pots
unlit; inedible; fixed in place; scenery; singular-named; improper-named; neuter; ordinarily enumerated; seen; unfamiliar; unswingable; one-of-many; not drinkable; weak_smelling; soft_sounding
description: Large pots made for holding Korea's favorite food. Big enough to climb into... or stand on.
printed name: open kimchi pot
printed plural name: containers
feeling: normal
flavor: normal
odor: normal
sound: silence
enterable; opaque; open; openable; unlocked
carrying capacity: 100
known-key: no-key
posture: seated

* * *

Blossom Street
A street stretches in front of you. You don't know this street, but it exists. Above you, and all around you, are cherry blossoms: they fill the street gutter; they overflow onto a yellow stripe of paint; they enter your nose, and come out your ears.

You see grass to the left. To the right is a yellow stripe, a streetlight, and a fence.

You could sit here if you wanted. You could run and dance on that yellow stripe. You could lie in the street and let the cherry blossoms bury you. If you wanted.

>hit stripe
You attack the yellow stripe of paint.

>sit down
You are now seated. You stare at your toes, and wonder how they got there.

>hit stripe
Violence is you.

>touch paper
You can't see any such thing.

>touch stripe
You slide a finger along the yellow stripe... it leaves a line through the blossoms.

>x line
You can't see any such thing.

>climb fence
You hoist yourself to the top of the fence.

You are now seated on the fence. Cross-legged.

>eat blossom
Which do you mean, the cherry blossoms or the cherry blossom trees?

>cherry blossoms
You put a flower in your mouth. It tastes like the past.

>lick myself
A bit of salt, a bit of skin. You're human after all.

>fly
(getting off the fence)
You are now flying in the sky. Like a plane.

>l
Blossom Street (in the sky)
A street stretches in front of you. You don't know this street, but it exists. Above you, and all around you, are cherry blossoms: they fill the street gutter; they overflow onto a yellow stripe of paint; they enter your nose, and come out your ears.

You see grass to the left. To the right is a yellow stripe, a streetlight, and a fence.

You could sit here if you wanted. You could run and dance on that yellow stripe. You could lie in the street and let the cherry blossoms bury you. If you wanted.

>hit myself
You can't see "myself" (yourself) at the moment.

>hit stripe
Violence is you.

* * *

>hit stripe
You attack the yellow stripe of paint.

>attack fence
You attack the fence.

>hit tree
You attack the cherry blossom trees.

I beg your pardon?

>div
That's not a verb I recognize.

* * *

>fly
You are now flying in the sky. Like the fastest things on earth.

>div
That's not a verb I recognize.

* * *

>fly
You are now flying in the sky. You feel a breeze behind you.

>l
Blossom Street (in the sky)
A street stretches in front of you. You don't know this street, but it exists. Above you, and all around you, are cherry blossoms: they fill the street gutter; they overflow onto a yellow stripe of paint; they enter your nose, and come out your ears.

You see grass to the left. To the right is a yellow stripe, a streetlight, and a fence.

You could sit here if you wanted. You could run and dance on that yellow stripe. You could lie in the street and let the cherry blossoms bury you. If you wanted.

* * *

>n
Maisan Mountain
After traveling north for some time you find yourself atop Maisain Mountain, looking out over the farmland of North Jeolla. There's a golf course down there that you might just be able to touch, as well as some man-made lakes and Geum River, winding itself towards the Yellow Sea.

You could dance in the sky here, if you wanted. You could probably fly.

>swim in river
You dive into the river and swim its full breadth, then lie back and have a float.

>dive
You plunge deep into the water, surrounding yourself with the cool liquid until you can hold your breath no more, then you surface again. You hear rain in the distance.

>swim in lake
(getting out of Geum River)
You jump into a lake. Cool water flows over you.

>dive
You plunge deep into the water, surrounding yourself with the cool liquid until you can hold your breath no more, then you surface again. The earth spins slowly.

>twirl
You can't take that position in the man-made lakes.

>get out
You get out of the man-made lakes.

Maisan Mountain
Maisain Mountain, looking out over the farmland of North Jeolla. There's a golf course down there that you might just be able to touch, as well as some man-made lakes and Geum River, winding itself towards the Yellow Sea.

You could dance in the sky here, if you wanted. You could probably fly.

>twirl
You are now dancing.

>twirl
You are already dancing.

>twirl
You are already dancing.

* * *

Blossom Street
A street stretches in front of you. You don't know this street, but it exists. Above you, and all around you, are cherry blossoms: they fill the street gutter; they overflow onto a yellow stripe of paint; they enter your nose, and come out your ears.

You see grass to the left. To the right is a yellow stripe, a streetlight, and a fence.

You could sit here if you wanted. You could run and dance on that yellow stripe. You could lie in the street and let the cherry blossoms bury you. If you wanted.

>run
You are now running. You feel a breeze behind you.

>run
You are already running.

>run
You are already running.

>dance
You are now dancing. Twirling ballet style.

>run
You are now running. Around and around in circles.

>dance
You are now dancing.

>run
You are now running. The wind behind you.

>dance
You are now dancing. Who says you can't breakdance?

>drun
That's not a verb I recognize.

>run
You are now running. Back and forth, 'till you're panting and out of breath.

>turn streetlight on
That's not something you can switch.

* * *

Blossom Street
A street stretches in front of you. You don't know this street, but it exists. Above you, and all around you, are cherry blossoms: they fill the street gutter; they overflow onto a yellow stripe of paint; they enter your nose, and come out your ears.

You see grass to the left. To the right is a yellow stripe, a streetlight, and a fence.

You could sit here if you wanted. You could run and dance on that yellow stripe. You could lie in the street and let the cherry blossoms bury you. If you wanted.

>turn on light
You wave your hand, and the streetlight turns on, as if by magic.

>turn off light
That's not something you can switch.

>switch light
You wave your hand, and the streetlight turns on, as if by magic.

>switch on light
You wave your hand, and the streetlight turns on, as if by magic.

* * *

Blossom Street
A street stretches in front of you. You don't know this street, but it exists. Above you, and all around you, are cherry blossoms: they fill the street gutter; they overflow onto a yellow stripe of paint; they enter your nose, and come out your ears.

You see grass to the left. To the right is a yellow stripe, a streetlight, and a fence.

You could sit here if you wanted. You could run and dance on that yellow stripe. You could lie in the street and let the cherry blossoms bury you. If you wanted.

>x light
You see nothing special about the streetlight.

>dance on light
You are now dancing on the streetlight. You feel a breeze behind you.

>sit on light
You are now seated on the streetlight. Legs out in front of you.

* * *

Blossom Street
A street stretches in front of you. You don't know this street, but it exists. Above you, and all around you, are cherry blossoms: they fill the street gutter; they overflow onto a yellow stripe of paint; they enter your nose, and come out your ears.

You see grass to the left. To the right is a yellow stripe, a streetlight, and a fence.

You could sit here if you wanted. You could run and dance on that yellow stripe. You could lie in the street and let the cherry blossoms bury you. If you wanted.

>turn on lamp
You wave your hand, and the streetlight turns on, as if by magic.

>turn on lamp
You wave your hand, and the streetlight turns on, as if by magic.

>turn off lamp
You blow at the light, and it turns off.

* * *

Blossom Street
A street stretches in front of you. You don't know this street, but it exists. Above you, and all around you, are cherry blossoms: they fill the street gutter; they overflow onto a yellow stripe of paint; they enter your nose, and come out your ears.

You see grass to the left. To the right is a yellow stripe, a streetlight, and a fence.

You could sit here if you wanted. You could run and dance on that yellow stripe. You could lie in the street and let the cherry blossoms bury you. If you wanted.

>climb lamp
You shimmy up the pole 'till you get to the lamp, and can go no higher. A bug peers out at you from behind the plastic.

>x bug
A little creepy crawly, enjoying its life while it lasts.

>x grass
You see nothing special about the grass.

>sit on grass
(getting off the streetlight)
You are now seated on the grass.

>taste grass
Tastes like something you've eaten before.

>n
(first leaving the grass)

Maisan Mountain
After traveling north for some time you find yourself atop Maisain Mountain, looking out over the farmland of North Jeolla. There's a golf course down there that you might just be able to touch, as well as some man-made lakes and Geum River, winding itself towards the Yellow Sea.

You could dance in the sky here, if you wanted. You could probably fly.

>x grass
You can't see any such thing.

>x course
You see nothing special about the golf course.

>x golf course
You see nothing special about the golf course.

>x lakes
You see nothing special about the man-made lakes.

>x river
You see nothing special about Geum River.

* * *

Blossom Street
A street stretches in front of you. You don't know this street, but it exists. Above you, and all around you, are cherry blossoms: they fill the street gutter; they overflow onto a yellow stripe of paint; they enter your nose, and come out your ears.

You see grass to the left. To the right is a yellow stripe, a streetlight, and a fence.

You could sit here if you wanted. You could run and dance on that yellow stripe. You could lie in the street and let the cherry blossoms bury you. If you wanted.

>x road
You see nothing special about the road.

* * *

Blossom Street
A street stretches in front of you. You don't know this street, but it exists. Above you, and all around you, are cherry blossoms: they fill the street gutter; they overflow onto a yellow stripe of paint; they enter your nose, and come out your ears.

You see grass to the left. To the right is a yellow stripe, a streetlight, and a fence.

You could sit here if you wanted. You could run and dance on that yellow stripe. You could lie in the street and let the cherry blossoms bury you. If you wanted.

>kiss road
Your lips touch the road. Just like when you were a kid... or maybe not.

>kiss fence
Your lips touch the fence. The breeze ruffles your hair.

>kiss lamp
Your lips touch the streetlight. Everything around you seems to drip color.

>taste flower
You put a flower in your mouth. It tastes like the past.

>kiss flower
Your lips touch the cherry blossoms. The world looks different.

>kiss tree
Your lips touch the cherry blossom trees. It feels like you've been here before.

* * *

Blossom Street
A street stretches in front of you. You don't know this street, but it exists. Above you, and all around you, are cherry blossoms: they fill the street gutter; they overflow onto a yellow stripe of paint; they enter your nose, and come out your ears.

You see grass to the left. To the right is a yellow stripe, a streetlight, and a fence.

You could sit here if you wanted. You could run and dance on that yellow stripe. You could lie in the street and let the cherry blossoms bury you. If you wanted.

>taste road
Tastes like dust and black tar.

>kiss road
You can only do that to something animate.

* * *

Blossom Street
A street stretches in front of you. You don't know this street, but it exists. Above you, and all around you, are cherry blossoms: they fill the street gutter; they overflow onto a yellow stripe of paint; they enter your nose, and come out your ears.

You see grass to the left. To the right is a yellow stripe, a streetlight, and a fence.

You could sit here if you wanted. You could run and dance on that yellow stripe. You could lie in the street and let the cherry blossoms bury you. If you wanted.

>walk
You are now walking. Above you is the sky.

>walk
You continue to walk.

>walk
You continue to walk.

>walk
You continue to walk. You close your eyes for a moment... and almost fall asleep.

>walk
You continue to walk.

>walk
You continue to walk. Life is good.

>walk
You continue to walk. The ether shifts around you.

>fly
You are now flying in the sky. Like a bird.

>dive
You soar up, and then down, twirling and gliding like you were born to do it. You hit a hot air patch and shoot upwards geyser style.

>fly
You are now flying in the sky.

>fly
You are now flying in the sky. Like a plane.

>dive
You soar up, and then down, twirling and gliding like you were born to do it.

>fly
You are now flying in the sky. Slowly, lazily, just for fun.

>sit
You can't take that position in the sky.

>sit on road
(getting out of the sky)
You are now seated on the road. You stare at your toes, and wonder how they got there.

>sit
You continue to sit.

>sit
You continue to sit. You hear thunder rumble in a distant land.

>n
(first leaving the road)

Maisan Mountain
After traveling north for some time you find yourself atop Maisain Mountain, looking out over the farmland of North Jeolla. There's a golf course down there that you might just be able to touch, as well as some man-made lakes and Geum River, winding itself towards the Yellow Sea.

You could dance in the sky here, if you wanted. You could probably fly.

>n
Napo Field
You fly north until you can fly no more. Then you land here, in a middle school soccer field.

The air is cool and crisp to the touch. Autumn has come, and the birds will be here soon, stopping in this field on their way south. Or maybe they've already been.

There are some parallel bars in the distance. You could swing from those bars, or climb that barren tree. Or you could just keep going north.

* * *

>n
Kimchi Pots
Walking north you come upon some gaint Kimchi pots.

If there was kimchi in one of those pots you could eat it... you could put it in your mouth and let the spices soak your tongue.

You could climb into one of the pots and sing until your voice was hoarse.

You could stand on top of one of them and jump up and down until someone made you stop.

You could do a million things. Or nothing at all.

>jump
You jump on the spot. You feel a breeze behind you.

>jump on pot
You'll need to open one of the pots first.

>jump on pot
You'll need to open one of the pots first.

>lie on pot
The pots are a bit small to lie on.

* * *

Blossom Street
A street stretches in front of you. You don't know this street, but it exists. Above you, and all around you, are cherry blossoms: they fill the street gutter; they overflow onto a yellow stripe of paint; they enter your nose, and come out your ears.

You see grass to the left. To the right is a yellow stripe, a streetlight, and a fence.

You could sit here if you wanted. You could run and dance on that yellow stripe. You could lie in the street and let the cherry blossoms bury you. If you wanted.

>jump
You are now jumping.

>jump
You continue to jump.

>jump
You continue to jump. You think of all the places you've never been.

>jump on road
You are now jumping on the road. The world looks different.

>jump
You jump on the spot, fruitlessly.

>jump on road
You are now jumping on the road. A beam of sunlight crosses in front of you.

>jump on road
You are now jumping on the road.

>jump on road
You are now jumping on the road.

>l
Blossom Street (on the road)
A street stretches in front of you. You don't know this street, but it exists. Above you, and all around you, are cherry blossoms: they fill the street gutter; they overflow onto a yellow stripe of paint; they enter your nose, and come out your ears.

You see grass to the left. To the right is a yellow stripe, a streetlight, and a fence.

You could sit here if you wanted. You could run and dance on that yellow stripe. You could lie in the street and let the cherry blossoms bury you. If you wanted.

>jump
You jump on the spot, fruitlessly.

>l
Blossom Street (on the road)
A street stretches in front of you. You don't know this street, but it exists. Above you, and all around you, are cherry blossoms: they fill the street gutter; they overflow onto a yellow stripe of paint; they enter your nose, and come out your ears.

You see grass to the left. To the right is a yellow stripe, a streetlight, and a fence.

You could sit here if you wanted. You could run and dance on that yellow stripe. You could lie in the street and let the cherry blossoms bury you. If you wanted.

* * *

>jump
You continue to jump. You think of all the places you've never been.

>jump
You continue to jump.

>jump on road
You are now jumping on the road.

>jump
You continue to jump.

>jump
You continue to jump. You hear rain in the distance.

>jump on stripe
(getting off the road)
You are now jumping on the yellow stripe of paint.

>l
Blossom Street (on the yellow stripe of paint)
A street stretches in front of you. You don't know this street, but it exists. Above you, and all around you, are cherry blossoms: they fill the street gutter; they overflow onto a yellow stripe of paint; they enter your nose, and come out your ears.

You see grass to the left. To the right is a yellow stripe, a streetlight, and a fence.

You could sit here if you wanted. You could run and dance on that yellow stripe. You could lie in the street and let the cherry blossoms bury you. If you wanted.

>jump
You continue to jump.

>jump
You continue to jump. A little bug buzzes by.

>jump
You continue to jump. The ether shifts around you.

* * *

Blossom Street
A street stretches in front of you. You don't know this street, but it exists. Above you, and all around you, are cherry blossoms: they fill the street gutter; they overflow onto a yellow stripe of paint; they enter your nose, and come out your ears.

You see grass to the left. To the right is a yellow stripe, a streetlight, and a fence.

You could sit here if you wanted. You could run and dance on that yellow stripe. You could lie in the street and let the cherry blossoms bury you. If you wanted.

>x raod
You can't see any such thing.

>x road
It's an asphalt road.

>x lamp
It's used to light the way for pedestrians out after dark.

>x street
It's an asphalt road.

>x stripe
It's a bold yellow centerline made by a striper. You could taste it if you wanted.

>smell stripe
Smells like paint and asphalt mixed with cherry blossoms.

>n
Maisan Mountain
After traveling north for some time you find yourself atop Maisain Mountain, looking out over the farmland of North Jeolla. There's a golf course down there that you might just be able to touch, as well as some man-made lakes and Geum River, winding itself towards the Yellow Sea.

You could dance in the sky here, if you wanted. You could probably fly.

>x water
Which do you mean, the man-made lakes or Geum River?

>lake
Irrigation is what it's all about in these plains.

>x lake
Irrigation is what it's all about in these plains.

>x river
One of the major rivers of South Korea, the Geum is beautiful, and life supporting.

* * *

Blossom Street
A street stretches in front of you. You don't know this street, but it exists. Above you, and all around you, are cherry blossoms: they fill the street gutter; they overflow onto a yellow stripe of paint; they enter your nose, and come out your ears.

You see grass to the left. To the right is a yellow stripe, a streetlight, and a fence.

You could sit here if you wanted. You could run and dance on that yellow stripe. You could lie in the street and let the cherry blossoms bury you. If you wanted.

>x flower
The cherry blossoms are everywhere, in everything. Fluffy and white like snow, but without the cold.

>taste it
You put a flower in your mouth. It tastes like the past.

>listen to it
Sounds like snow.

* * *

Blossom Street
A street stretches in front of you. You don't know this street, but it exists. Above you, and all around you, are cherry blossoms: they fill the street gutter; they overflow onto a yellow stripe of paint; they enter your nose, and come out your ears.

You see grass to the left. To the right is a yellow stripe, a streetlight, and a fence.

You could sit here if you wanted. You could run and dance on that yellow stripe. You could lie in the street and let the cherry blossoms bury you. If you wanted.

>kiss the road
Your lips touch the road.

* * *

Blossom Street
A street stretches in front of you. You don't know this street, but it exists. Above you, and all around you, are cherry blossoms: they fill the street gutter; they overflow onto a yellow stripe of paint; they enter your nose, and come out your ears.

You see grass to the left. To the right is a yellow stripe, a streetlight, and a fence.

You could sit here if you wanted. You could run and dance on that yellow stripe. You could lie in the street and let the cherry blossoms bury you. If you wanted.

>taste flower
You put a flower in your mouth. It tastes like the past.

>kiss road
Your lips touch the road.

>kiss road
Your lips touch the road. You hear rain in the distance.

>move north
Maisan Mountain
After traveling north for some time you find yourself atop Maisain Mountain, looking out over the farmland of North Jeolla. There's a golf course down there that you might just be able to touch, as well as some man-made lakes and Geum River, winding itself towards the Yellow Sea.

You could dance in the sky here, if you wanted. You could probably fly.

>sing
You are now singing. Just like when you were a kid... or maybe not.

>fly in sky
You are now flying in the sky. You feel millions of Nitrogen and Oxygen particles hitting your skin.

>dive
You soar up, and then down, twirling and gliding like you were born to do it. Like the fastest things on earth.

>get down
You get out of the sky.

Maisan Mountain
Maisain Mountain, looking out over the farmland of North Jeolla. There's a golf course down there that you might just be able to touch, as well as some man-made lakes and Geum River, winding itself towards the Yellow Sea.

You could dance in the sky here, if you wanted. You could probably fly.

>swim in lake
You jump into a lake. Cool water flows over you.

>dive
You plunge deep into the water, surrounding yourself with the cool liquid until you can hold your breath no more, then you surface again.

>l
Maisan Mountain (in the man-made lakes)
Maisain Mountain, looking out over the farmland of North Jeolla. There's a golf course down there that you might just be able to touch, as well as some man-made lakes and Geum River, winding itself towards the Yellow Sea.

You could dance in the sky here, if you wanted. You could probably fly.

* * *

Blossom Street
A street stretches in front of you. You don't know this street, but it exists. Above you, and all around you, are cherry blossoms: they fill the street gutter; they overflow onto a yellow stripe of paint; they enter your nose, and come out your ears.

You see grass to the left. To the right is a yellow stripe, a streetlight, and a fence.

You could sit here if you wanted. You could run and dance on that yellow stripe. You could lie in the street and let the cherry blossoms bury you. If you wanted.

>wait
The cherry blossoms pile higher.

>wait
Time passes. A beam of sunlight crosses in front of you.

>wait
The cherry blossoms pile higher still.

>wait
Time passes.

>wait
The cherry blossoms cover you.

>wait
Time passes. You hear thunder rumble in a distant land.

* * *

>wait
Time stands still.

>wait
Time stands still.

>wait
Time passes.

* * *

>wait
Time stands still.

>wait
Time passes. You feel a breeze behind you.

* * *

>wait
Time passes.

>wait
Time passes. The breeze ruffles your hair.

>wait
Time passes. The world looks different.

>wait
Time passes. You close your eyes, but the world is still there, in front of you.

* * *

>wait
Time passes.

>wait
Time passes. Above you is the sky.

>wait
Time passes. Just like when you were a kid... or maybe not.

>wait
Time passes. You think of all the places you've never been.

>wait
Time passes. You hear rain in the distance.

>wait
Time passes.

>wait
Time stands still. You close your eyes for a moment... and almost fall asleep.

>wait
Time stands still. The earth spins slowly.

>wait
Time stands still. A little bug buzzes by.

>wait
Time passes.

* * *

When you are ready to leave a location, type "go north," or "go west." Alternately you can just type "leave."

Please press SPACE to continue.

>sit
You are now seated. You feel a pebble beneath your buttock.

>move pebble
You can't see any such thing.

>dance
You are now dancing.

>lie down
You are now reclining. Arms outstretched.

>take a nap
You can't see any such thing.

>go north
(first standing up)

Maisan Mountain
After traveling north for some time you find yourself atop Maisain Mountain, looking out over the farmland of North Jeolla. There's a golf course down there that you might just be able to touch, as well some man-made lakes and Geum River, winding itself towards the Yellow Sea.

You could dance in the sky here, if you wanted. You could probably fly.

>golf
That's not a verb I recognize.

>fly
You are now flying. You feel a breeze behind you.

>go south
(first standing up)

Blossom Street
A street stretches in front of you. You don't know this street, but it exists. Above you, and all around you, are cherry blossoms: they fill the street gutter; they overflow onto a yellow stripe of paint; they enter your nose, and come out your ears.

You see grass to the left. To the right is a yellow stripe, a streetlight, and a fence.

You could sit here if you wanted. You could run and dance on that yellow stripe. You could lie in the street and let the cherry blossoms burry you. If you wanted.

>go east
You can't go that way.

>s
Being There
"Being There" is short, experimental work of interactive fiction about existence and Korea. It is not a game, and you don't need to be familiar with interactive fiction to play it.

During the course of play you will be taken to a series of locations. In each location you can do various things by typing commands into the text prompt. Try things like:

 listen
 touch the street
 dance on the sidewalk
 climb the tree
 taste the flower

When you are ready to leave a location, type "go north," or "go west." Alternately you can just type "leave."

Please press SPACE to continue.

* * *

Blossom Street
A street stretches in front of you. You don't know this street, but it exists. Above you, and all around you, are cherry blossoms: they fill the street gutter; they overflow onto a yellow stripe of paint; they enter your nose, and come out your ears.

You see grass to the left. To the right is a yellow stripe, a streetlight, and a fence.

You could sit here if you wanted. You could run and dance on that yellow stripe. You could lie in the street and let the cherry blossoms burry you. If you wanted.

>taste the flower
You put a flower in your mouth. It tastes like the past.

>x flower
The cherry blossoms are everywhere, in everything. Fluffy and white like snow, but without the cold.

>x stripe
It's a bold yellow centerline made by a striper. You could taste it if you wanted.

>smell
Smells surround you...
...paint and asphalt mixed with cherry blossoms.
...the grassy green odor you know so well from all the time you've spent lying in it.
...earthworms and rubber.
...perfume.
...something sweet and dewy.
...something sweet and dewy, mixed with bark.

* * *

When you are ready to leave a location, type "go north," or "go west." Alternately you can just type "leave."

Please press SPACE to continue.

>x breeze
It's the breeze.

* * *

When you are ready to leave a location, type "go north," or "go west." Alternately you can just type "leave."

Please press SPACE to continue.

>move pebble
It is fixed in place.

>take pebble
The pebble is no longer nagging your buttock.

* * *

When you are ready to leave a location, type "go north," or "go west." Alternately you can just type "leave."

Please press SPACE to continue.

>take pebble
You move the pebble out of the way, to satisfy your buttock.

>move pebble
You move the pebble out of the way, to satisfy your buttock.

* * *

When you are ready to leave a location, type "go north," or "go west." Alternately you can just type "leave."

Please press SPACE to continue.

>go west
Maisan Mountain
After traveling west for some time you find yourself atop Maisain Mountain, looking out over the farmland of North Jeolla. There's a golf course down there that you might just be able to touch, as well some man-made lakes and Geum River, winding itself towards the Yellow Sea.

You could dance in the sky here, if you wanted. You could probably fly.

>go west
Napo Field
You fly west until you can fly no more. Then you land here, in a middle school soccer field.

The air is cool and crisp to the touch. Autumn has come, and the birds will be here soon, stopping in this field on their way south. Or maybe they've already been.

There are some parallel bars in the distance. You could swing from those bars, or climb that barren tree. Or yoo could just keep going west.

>climb tree
You climb to the top of the barren tree. The field looks distant, and small.

>look
Napo Field
You fly west until you can fly no more. Then you land here, in a middle school soccer field.

The air is cool and crisp to the touch. Autumn has come, and the birds will be here soon, stopping in this field on their way south. Or maybe they've already been.

There are some parallel bars in the distance. You could swing from those bars, or climb that barren tree. Or yoo could just keep going west.

>look at fields
You can't see any such thing.

>look at field
Most Korean soccer fields are worn to dirt. This one is surprisingly well-carpeted.

>play soccer
I didn't understand that sentence.

>swing on bars
You swing around and around and around.

>stop
That's not a verb I recognize.

>go west
Temple Spring
You wander west for hours, searching for you don't know what. And then you find it: a fresh spring at the temple of the nirvana fish, spouting clean, cold water from a bamboo shoot.

The water flows onto a stone platform, then over the edge, and away.

You can see a cup here.

>drink
(the water)
Ignoring the cups, you place your mouth to the fountain, and drink for a long moment. The water freezes your lips and chin, but it tastes like heaven.

>use cup
You take one of the cups and dip it into the stream of water; then you drink a long draught.

>wash face
That's not a verb I recognize.

>wash hands
That's not a verb I recognize.

>go west
Kimchi Pots
Walking west you come upon some gaint Kimchi pots.

If there was kimchi in one of those pots you could eat it... you could put it in your mouth and let the spices soak your tongue.

You could climb into one of the pots and sing until your voice was hoarse.

You could stand on top of one of them and jump up and down until someone made you stop.

You could do a million things. Or nothing at all.

>eat
What do you want to eat?

* * *

>kimchi
You can't see any such thing.

>eat Kimchi
You can't see any such thing.

>open pot
You open a kimchi pot, revealing more kimchi than you know what to do with.

* * *

>eat kimchi
You take a bite of the kimchi. Spicy and delicious.

>eat more kimchi
You can't see any such thing.

>eat kimchi
You take another bite.

>eat kimchi
You eat more. And more. You're starting to get addicted.

>sit in pot
You are now seated on an open kimchi pot. You feel a pebble beneath your buttock.

>sing
You are now singing on an open kimchi pot. You belt it out like a good one.

>eat kimchi
Okay, you're officially addicted.

>go west
You'll have to get out of the open kimchi pot first.

>get out of kimchi pot
I only understood you as far as wanting to get outside.

>stand up
You are now standing on an open kimchi pot. You feel tall.

>get out
You get out of the open kimchi pot.

Kimchi Pots
Walking west you come upon some gaint Kimchi pots.

If there was kimchi in one of those pots you could eat it... you could put it in your mouth and let the spices soak your tongue.

You could climb into one of the pots and sing until your voice was hoarse.

You could stand on top of one of them and jump up and down until someone made you stop.

You could do a million things. Or nothing at all.

>count to a million
That's not a verb I recognize.

>go west
A Stream
You run far this time, and come upon a stream where a father plays with his two daughters.

>go swimming
You can't see any such thing.

* * *

>swim
(in the stream)
Some might say the water's a bit shallow for swimming, but that doesn't stop you from diving in head first and splashing about like a maniac.

>talk to father
You can't see any such thing.

>talk to girls
The girl in the striped suit looks over at you and smiles. The other girl is too busy trying not to slip to notice your voice.

>say hello
You are already talking to the Korean girls.

>sing
You are now singing. No one to say if you're any good or not.

>splash the girls
That's not a verb I recognize.

>go west
The girls giggle and point at you enthusiastically.

Sandlot
You follow the stream, walking west, until the stream becomes a river and you can no longer touch the bottom. Then you float with your eyes closed, until the river washes you up on an asphalt shore, where two boys play baseball at dusk.

You feel your time is drawing short. You won't be able to stay here long.

>say hello
(addressing the baseball players)
The boys turn and look at you. "Hello! Hello!" they shout excitedly.

>hello
You are already talking to the baseball players.

>play baseball
I didn't understand that sentence.

>go west
"My name is Bong-cha! My name is Chang-sun!" yell the boys.

A Group of Boys
You make your way qucikly west, but a group of smiling boys jumps in front of you.

"Kimchi! My name is Bae! Hello! I love you! My name is Chin-ho!"

>hello
(addressing the boys)
"Annyeonghaseyo!" yell the boys in unison. One of them is jumping uncontrollably.

>annyeonghaseyo
There is no more time to spare: you must keep moving.

>go west
There is no more time to spare: you must keep moving.

A Pavilion
You manage to break away from the group of boys. Running now, panting, you've hardly any time left. Glancing to your right, you see a man helping a yong boy take off his shoes before entering a pavilion.

>take off shoes
There is no time to stop now.

>*spelling error
(Noted.)

>go west
Leaving
You're flying now, faster than you've ever flown before... the air that streams by you feels like a thick liquid. Glancing over your shoulder, your last glimpse of Korea is a girl in red stripes, holding an umbrella.

And then she's gone.

>b
Being There. A notgame for Korea, created by Jordan Magnuson.

* * *

When you are ready to leave a location, type "go north," or "go west." Alternately you can just type "leave."

Please press SPACE to continue.

>bathe
You have a nice bathe.

>wash road
You wash the road.

>wash head
You can't see any such thing.

>wash fafce
You can't see any such thing.

>wash face
You can't see any such thing.

>wash hands
You wash your hands.

* * *

When you are ready to leave a location, type "go north," or "go west." Alternately you can just type "leave."

Please press SPACE to continue.

>kimcih
That's not a verb I recognize.

>kimchi
You need to open the pot first

>n
Maisan Mountain
After traveling north for some time you find yourself atop Maisain Mountain, looking out over the farmland of North Jeolla. There's a golf course down there that you might just be able to touch, as well some man-made lakes and Geum River, winding itself towards the Yellow Sea.

You could dance in the sky here, if you wanted. You could probably fly.

* * *

When you are ready to leave a location, type "go north," or "go west." Alternately you can just type "leave."

Please press SPACE to continue.

>kimchi
That's not a verb I recognize.

>eat kimchi
You can't see any such thing.

>n
Maisan Mountain
After traveling north for some time you find yourself atop Maisain Mountain, looking out over the farmland of North Jeolla. There's a golf course down there that you might just be able to touch, as well some man-made lakes and Geum River, winding itself towards the Yellow Sea.

You could dance in the sky here, if you wanted. You could probably fly.

* * *

>n
Kimchi Pots
Walking north you come upon some gaint Kimchi pots.

If there was kimchi in one of those pots you could eat it... you could put it in your mouth and let the spices soak your tongue.

You could climb into one of the pots and sing until your voice was hoarse.

You could stand on top of one of them and jump up and down until someone made you stop.

You could do a million things. Or nothing at all.

>eat
You need to open the pot first.

>kimchi
That's not a verb I recognize.

>eat kimchi
You need to open the pot first.

>kimchi
That's not a verb I recognize.

>eat
You need to open the pot first.

>eat
You need to open the pot first.

I beg your pardon?

>eat
You need to open the pot first.

* * *

When you are ready to leave a location, type "go north," or "go west." Alternately you can just type "leave."

Please press SPACE to continue.

>drink water
You can't see any such thing.

>n
Maisan Mountain
After traveling north for some time you find yourself atop Maisain Mountain, looking out over the farmland of North Jeolla. There's a golf course down there that you might just be able to touch, as well some man-made lakes and Geum River, winding itself towards the Yellow Sea.

You could dance in the sky here, if you wanted. You could probably fly.

>drink
What do you want to drink?

* * *

>river
Tastes fresh and earthy... no chlorine here.

>n
Napo Field
You fly north until you can fly no more. Then you land here, in a middle school soccer field.

The air is cool and crisp to the touch. Autumn has come, and the birds will be here soon, stopping in this field on their way south. Or maybe they've already been.

There are some parallel bars in the distance. You could swing from those bars, or climb that barren tree. Or yoo could just keep going north.

* * *

I beg your pardon?

>drink
What do you want to drink?

>n
You must name something more substantial.

>drink grass
There's nothing suitable to drink here.

>n
Temple Spring
You wander north for hours, searching for you don't know what. And then you find it: a fresh spring at the temple of the nirvana fish, spouting clean, cold water from a bamboo shoot.

The water flows onto a stone platform, then over the edge, and away.

You can see a cup here.

* * *

>n
A Stream
You run far this time, and come upon a stream where a father plays with his two daughters.

>drink water
You bend down, place your head in the stream, and open your mouth. The water rushes into mouth, down your throat, and fills your stomach. Bloated, you fall over with a splash. You are now reclining in the stream.

>n
Sandlot
You follow the stream, walking north, until the stream becomes a river and you can no longer touch the bottom. Then you float with your eyes closed, until the river washes you up on an asphalt shore, where two boys play baseball at dusk.

You feel your time is drawing short. You won't be able to stay here long.

* * *

Blossom Street
A street stretches in front of you. You don't know this street, but it exists. Above you, and all around you, are cherry blossoms: they fill the street gutter; they overflow onto a yellow stripe of paint; they enter your nose, and come out your ears.

You see grass to the left. To the right is a yellow stripe, a streetlight, and a fence.

You could sit here if you wanted. You could run and dance on that yellow stripe. You could lie in the street and let the cherry blossoms burry you. If you wanted.

>w
From here, the viable exits are to the north and the south.

* * *

Blossom Street
A street stretches in front of you. You don't know this street, but it exists. Above you, and all around you, are cherry blossoms: they fill the street gutter; they overflow onto a yellow stripe of paint; they enter your nose, and come out your ears.

You see grass to the left. To the right is a yellow stripe, a streetlight, and a fence.

You could sit here if you wanted. You could run and dance on that yellow stripe. You could lie in the street and let the cherry blossoms burry you. If you wanted.

>x pebble
Just a little rock, probably millions of years old.

>move pebble
It is fixed in place.

* * *

Blossom Street
A street stretches in front of you. You don't know this street, but it exists. Above you, and all around you, are cherry blossoms: they fill the street gutter; they overflow onto a yellow stripe of paint; they enter your nose, and come out your ears.

You see grass to the left. To the right is a yellow stripe, a streetlight, and a fence.

You could sit here if you wanted. You could run and dance on that yellow stripe. You could lie in the street and let the cherry blossoms burry you. If you wanted.

>x streetlamp
It's used to light the way for pedestrians out after dark.

* * *

Blossom Street
A street stretches in front of you. You don't know this street, but it exists. Above you, and all around you, are cherry blossoms: they fill the street gutter; they overflow onto a yellow stripe of paint; they enter your nose, and come out your ears.

You see grass to the left. To the right is a yellow stripe, a streetlight, and a fence.

You could sit here if you wanted. You could run and dance on that yellow stripe. You could lie in the street and let the cherry blossoms burry you. If you wanted.

>x far side
Looks to be a convention center of some sort, or a hotel. You can see the hole where the pool will be.

* * *

Blossom Street
A street stretches in front of you. You don't know this street, but it exists. Above you, and all around you, are cherry blossoms: they fill the street gutter; they overflow onto a yellow stripe of paint; they enter your nose, and come out your ears.

You see grass to the left. To the right is a yellow stripe, a streetlight, and a fence.

You could sit here if you wanted. You could run and dance on that yellow stripe. You could lie in the street and let the cherry blossoms bury you. If you wanted.

>climb tree
You grab a branch and swing yourself up, into the midst of the blossoms. Kind of like being in a snowglobe.

>climb on tree
You grab a branch and swing yourself up, into the midst of the blossoms. Kind of like being in a snowglobe.

>up
If you want to climb something, try the command "climb"; if you want to enter the sky, try "jump" or "fly."

>climb
What do you want to climb?

>d
You must name something more substantial.

>climb
What do you want to climb?

>up
You must name something more substantial.

>up
If you want to climb something, try the command "climb"; if you want to enter the sky, try "jump" or "fly."

>climb tree
You grab a branch and swing yourself up, into the midst of the blossoms. Kind of like being in a snowglobe.

>l
Blossom Street
A street stretches in front of you. You don't know this street, but it exists. Above you, and all around you, are cherry blossoms: they fill the street gutter; they overflow onto a yellow stripe of paint; they enter your nose, and come out your ears.

You see grass to the left. To the right is a yellow stripe, a streetlight, and a fence.

You could sit here if you wanted. You could run and dance on that yellow stripe. You could lie in the street and let the cherry blossoms bury you. If you wanted.

>climb tree
You grab a branch and swing yourself up, into the midst of the blossoms. Kind of like being in a snowglobe.

>climb tree
You grab a branch and swing yourself up, into the midst of the blossoms. Kind of like being in a snowglobe.

>d
You are not on anything.

>climb tree
You grab a branch and swing yourself up, into the midst of the blossoms. Kind of like being in a snowglobe.

>climb trree
You can't see any such thing.

* * *

>climb tree
You grab a branch and swing yourself up, into the midst of the blossoms. Kind of like being in a snowglobe.

>sit on road
You are now seated on the road. You feel a pebble beneath your buttock.

>sit on road
You are now seated on the road. You feel a breeze behind you.

>sit down
You are already seated.

>sit on roa
You can't see any such thing.

>climb fence
That's not something you can enter.

>d
You let yourself back down to the ground.

>climb tree
You grab a branch and swing yourself up, into the midst of the blossoms. Kind of like being in a snowglobe.

* * *

>l
Blossom Street
A street stretches in front of you. You don't know this street, but it exists. Above you, and all around you, are cherry blossoms: they fill the street gutter; they overflow onto a yellow stripe of paint; they enter your nose, and come out your ears.

You see grass to the left. To the right is a yellow stripe, a streetlight, and a fence.

You could sit here if you wanted. You could run and dance on that yellow stripe. You could lie in the street and let the cherry blossoms bury you. If you wanted.

>climb on tree
You grab a branch and swing yourself up, into the midst of the blossoms. Kind of like being in a snowglobe.

>l
Blossom Street
A street stretches in front of you. You don't know this street, but it exists. Above you, and all around you, are cherry blossoms: they fill the street gutter; they overflow onto a yellow stripe of paint; they enter your nose, and come out your ears.

You see grass to the left. To the right is a yellow stripe, a streetlight, and a fence.

You could sit here if you wanted. You could run and dance on that yellow stripe. You could lie in the street and let the cherry blossoms bury you. If you wanted.

>do
You can't ask direct questions to the game. Type a verb - noun command like EXAMINE SOMETHING to interact with the story world.

>down
You are not on anything.

* * *

Being There

During the course of play you will be taken to a series of locations. In each location you can do various things by typing commands into the text prompt. Try things like:

listen
examine the stripe
touch the street
dance on the sidewalk
climb the tree
taste the flower

Please press SPACE to continue.

>tell korean man about me
The man smiles and nods.

The man glances at you and smiles.

>tell korean man about stream
The man attempts to wave at you, but realizes he doens't have any hands free.

>ask korean man about water
There is no reply.

>ask korean man about girls
There is no reply.

>tell korean man about girls
The man smiles and nods.

>say hello
You are already talking to the Korean man.

>stop
You stop what you're doing.

>say hello
You are already talking to the Korean man.

>n
The man glances at you and smiles.

Sandlot
You follow the stream, walking north, until the stream becomes a river and you can no longer touch the bottom. Then you float with your eyes closed, until the river washes you up on an asphalt shore, where two boys play baseball at dusk.

You feel your time is drawing short. You won't be able to stay here long.

>say hello
(addressing the baseball players)
The boys seem focused on their baseball playing.

>say hello
You are already talking to the baseball players.

>tell boys about me
The boys turn and look at you. "Hello! Hello!" they shout excitedly.

>tell boys about water
(Lake Eunpa)
"My name is Bong-cha! My name is Chang-sun!" yell the boys.

>say hi to boys
Time is short: you must leave this place.

* * *

Being There

During the course of play you will be taken to a series of locations. In each location you can do various things by typing commands into the text prompt. Try things like:

listen
examine the stripe
touch the street
dance on the sidewalk
climb the tree
taste the flower

Please press SPACE to continue.

>say boo
Whom do you want to say that to?

>girl
(the Korean girls)
The girl in the striped suit looks over at you and smiles. The other girl is too busy trying not to slip to notice your voice.

There is no reply.

>say ha
Whom do you want to say that to?

>girl
(the Korean girls)
There is no reply.

>say booya
Whom do you want to say that to?

>girl
(the Korean girls)
There is no reply.

* * *

Being There

During the course of play you will be taken to a series of locations. In each location you can do various things by typing commands into the text prompt. Try things like:

listen
examine the stripe
touch the street
dance on the sidewalk
climb the tree
taste the flower

Please press SPACE to continue.

>ask man about water
The man smiles and nods.

>ask man about me
The man attempts to wave at you, but realizes he doens't have any hands free.

>ask man about you
The man glances at you and smiles.

>tell man about you
The man smiles and nods.

>say hi to man
The man attempts to wave at you, but realizes he doens't have any hands free.

>say bye to man
The man glances at you and smiles.

>say booasdf to man
The man smiles and nods.

>say anything to man
The man attempts to wave at you, but realizes he doens't have any hands free.

>say boosbas
Whom do you want to say that to?

>man
The man glances at you and smiles.

>ask girl about water
(the Korean girls about the stream)
The girls giggle and point at you enthusiastically.

>say sdfdsf
Whom do you want to say that to?

>girl
(the Korean girls)
The girl in the striped suit looks over at you and smiles. The other girl is too busy trying not to slip to notice your voice.

>n
Sandlot
You follow the stream, walking north, until the stream becomes a river and you can no longer touch the bottom. Then you float with your eyes closed, until the river washes you up on an asphalt shore, where two boys play baseball at dusk.

You feel your time is drawing short. You won't be able to stay here long.

>tell boys something
The boys turn and look at you. "Hello! Hello!" they shout excitedly.

>say hello
(addressing the baseball players)
"My name is Bong-cha! My name is Chang-sun!" yell the boys.

>ask about baseball
(the baseball players)
(addressing the baseball players)
The boys seem focused on their baseball playing.

You must supply a noun.

>ask boys about baseball
(the baseball players)
The boys seem focused on their baseball playing.

>say hello
Time is short: you must leave this place.

* * *

Blossom Street
A street stretches in front of you. You don't know this street, but it exists. Above you, and all around you, are cherry blossoms: they fill the street gutter; they overflow onto a yellow stripe of paint; they enter your nose, and come out your ears.

You see grass to the left. To the right is a yellow stripe, a streetlight, and a fence.

You could sit here if you wanted. You could run and dance on that yellow stripe. You could lie in the street and let the cherry blossoms bury you. If you wanted.

>fly east
*** Run-time problem P39: Attempt to say a snippet value which is currently invalid: words 0 to 0.

Maisan Mountain
After traveling north for some time you find yourself atop Maisain Mountain, looking out over the farmland of North Jeolla. There's a golf course down there that you might just be able to touch, as well some man-made lakes and Geum River, winding itself towards the Yellow Sea.

You could dance in the sky here, if you wanted. You could probably fly.

* * *

Blossom Street
A street stretches in front of you. You don't know this street, but it exists. Above you, and all around you, are cherry blossoms: they fill the street gutter; they overflow onto a yellow stripe of paint; they enter your nose, and come out your ears.

You see grass to the left. To the right is a yellow stripe, a streetlight, and a fence.

You could sit here if you wanted. You could run and dance on that yellow stripe. You could lie in the street and let the cherry blossoms bury you. If you wanted.

>hit stripe
Violence is you.

>hit fence
Violence is you.

>kick fence
That's not a verb I recognize.

>attack fence
Violence is you.

* * *

Being There

During the course of play you will be taken to a series of locations. In each location you can do various things by typing commands into the text prompt. Try things like:

listen
examine the stripe
touch the street
dance on the sidewalk
climb the tree
taste the flower

Please press SPACE to continue.

>jump on pot
You are now jumping on a closed kimchi pot. 

You jump up and down like a maniac on the ceramic lid of the kimchi pot. You better hope it doesn't break under you!

>l
Kimchi Pots (on the closed kimchi pot)
If there was kimchi in one of those pots you could eat it... you could put it in your mouth and let the spices soak your tongue.

You could climb into one of the pots and sing until your voice was hoarse.

You could stand on top of one of them and jump up and down until someone made you stop.

You could do a million things. Or nothing at all.

>jump
You continue to jump. Above you is the sky.

>jump
You continue to jump.

>jump
You continue to jump. The earth spins slowly.

>jump
You continue to jump. Something around you smells... interesting.

>jump on pot
You are now jumping on a closed kimchi pot. 

You jump up and down like a maniac on the ceramic lid of a kimchi pot. You better hope it doesn't break under you!

* * *

>l
Kimchi Pots (on the closed kimchi pot)
If there was kimchi in one of those pots you could eat it... you could put it in your mouth and let the spices soak your tongue.

You could climb into one of the pots and sing until your voice was hoarse.

You could stand on top of one of them and jump up and down until someone made you stop.

You could do a million things. Or nothing at all.

>jump on pot
You jump up and down like a maniac on the ceramic lid of a kimchi pot. You better hope it doesn't break under you!

You are now jumping on a closed kimchi pot.

>jump in pot
You jump up and down like a maniac on the ceramic lid of a kimchi pot. You better hope it doesn't break under you!

You are now jumping on a closed kimchi pot. You hear rain in the distance.

* * *

>jump on pot
You are now jumping on a closed kimchi pot. 

You jump up and down like a maniac on the ceramic lid of the kimchi pot. You better hope it doesn't break under you!

>jump on pot
You are now jumping on a closed kimchi pot. 

You jump up and down like a maniac on the ceramic lid of the kimchi pot. You better hope it doesn't break under you!

* * *

>l
Kimchi Pots (on the closed kimchi pot)
If there was kimchi in one of those pots you could eat it... you could put it in your mouth and let the spices soak your tongue.

You could climb into one of the pots and sing until your voice was hoarse.

You could stand on top of one of them and jump up and down until someone made you stop.

You could do a million things. Or nothing at all.

>jump on pot
You are now jumping on a closed kimchi pot. 

You jump up and down like a maniac on the ceramic lid of a kimchi pot. You better hope it doesn't break under you!

>jump
You jump on the spot.

>jump
You jump on the spot. Just like when you were a kid... or maybe not.

>sing on pot
You are now singing on a closed kimchi pot. Tiny drums in your ears vibrate in time.

>sing
You continue to sing. The earth spins slowly.

>sing
You continue to sing. The world looks different.

>l
Kimchi Pots (on the closed kimchi pot)
If there was kimchi in one of those pots you could eat it... you could put it in your mouth and let the spices soak your tongue.

You could climb into one of the pots and sing until your voice was hoarse.

You could stand on top of one of them and jump up and down until someone made you stop.

You could do a million things. Or nothing at all.

* * *

>jump on pot
You are now jumping on a closed kimchi pot. 

You jump up and down like a maniac on the ceramic lid of a kimchi pot. You better hope it doesn't break under you!

>n
(first leaving the closed kimchi pot)

A Stream
You run far this time, and come upon a stream where a father plays with his two daughters.

>jump
You jump on the spot. Life is good.

>l
A Stream
A stream where a father plays with his two daughters.

>ump
That's not a verb I recognize.

>jump in stream
You are now jumping in the stream.

>jump
You jump on the spot. You feel a breeze behind you.

* * *

>jump on pot
You are now jumping on a closed kimchi pot. 

You jump up and down like a maniac on the ceramic lid of the kimchi pot. You better hope it doesn't break under you!

>jump on pot
The ceramic lid has had all the abuse it can take. It breaks. You land in a mountain of kimchi.

>l
Kimchi Pots (in the kimchi pot)
If there was kimchi in one of those pots you could eat it... you could put it in your mouth and let the spices soak your tongue.

You could climb into one of the pots and sing until your voice was hoarse.

You could stand on top of one of them and jump up and down until someone made you stop.

You could do a million things. Or nothing at all.

In the kimchi pot you can see a small mountain of kimchi.

>smell kimchi
Smells like strongly spiced cabbage.

* * *

>jump on pot
You are now jumping on a closed kimchi pot. 

You jump up and down like a maniac on the ceramic lid of the kimchi pot. You better hope it doesn't break under you!

>open pot
You open a kimchi pot, revealing more kimchi than you know what to do with.

>jump in pot
(getting off the closed kimchi pot)
You are now jumping in an open kimchi pot. 

The cabbage protests by belching and squeaking under your feet.

>l
Kimchi Pots (in the open kimchi pot)
If there was kimchi in one of those pots you could eat it... you could put it in your mouth and let the spices soak your tongue.

You could climb into one of the pots and sing until your voice was hoarse.

You could stand on top of one of them and jump up and down until someone made you stop.

You could do a million things. Or nothing at all.

In the open kimchi pot you can see a small mountain of kimchi.

>jump
You continue to jump.

>jump
You continue to jump. You wonder how you ended up here.

>jump
You continue to jump.

>jump in pot
You are now jumping in an open kimchi pot. Everything around you seems to drip color.

The cabbage protests by belching and squeaking under your feet.

>jump in pot
You are now jumping in an open kimchi pot. 

The cabbage protests by belching and squeaking under your feet.

>jump in pot
You are now jumping in an open kimchi pot. 

The cabbage protests by belching and squeaking under your feet.

>jump on pot
(getting out of the open kimchi pot)
You are now jumping on a closed kimchi pot. 

You jump up and down like a maniac on the ceramic lid of a kimchi pot. You better hope it doesn't break under you!

>jump
You continue to jump. You close your eyes for a moment... and almost fall asleep.

>jump
You continue to jump. The ether shifts around you.

>jump
You continue to jump. You feel a breeze behind you.

>jump
You continue to jump. Life is good.

>jump on pot
You are now jumping on a closed kimchi pot. Something around you smells... interesting.

You jump up and down like a maniac on the ceramic lid of a kimchi pot. You better hope it doesn't break under you!

* * *

>jump on pot
You are now jumping on a closed kimchi pot. 

You jump up and down like a maniac on the ceramic lid of the kimchi pot. You better hope it doesn't break under you!

>jump
You continue to jump. You hear thunder rumble in a distant land.

>jump
You continue to jump. Something around you smells... interesting.

>jump
You continue to jump.

>jump
You continue to jump. Above you is the sky.

>jump
You continue to jump. You feel a breeze behind you.

>jump on pot
You are now jumping on a closed kimchi pot. 

You jump up and down like a maniac on the ceramic lid of the kimchi pot. You better hope it doesn't break under you!

>jump on pot
The ceramic lid has had all the abuse it can take.

>jump
You continue to jump. Everything around you seems to drip color.

>jump
You continue to jump. You think of all the places you've never been.

* * *

>jump
You continue to jump.

>jump
You continue to jump.

>jump
You continue to jump. It feels like you've been here before.

>jump
You continue to jump. The ether shifts around you.

>jump
You continue to jump.

* * *

Being There

During the course of play you will be taken to a series of locations. In each location you can do various things by typing commands into the text prompt. Try things like:

listen
examine the stripe
touch the street
dance on the sidewalk
climb the tree
taste the flower

Please press SPACE to continue.

>stand on pot
You are now standing on a closed kimchi pot. You can feel it through your legs.

>stand
You continue to stand. The breeze ruffles your hair.

>l
Kimchi Pots (on the closed kimchi pot)
If there was kimchi in one of those pots you could eat it... you could put it in your mouth and let the spices soak your tongue.

You could climb into one of the pots and sing until your voice was hoarse.

You could stand on top of one of them and jump up and down until someone made you stop.

You could do a million things. Or nothing at all.

>sit on pot
You are now sitting on one of the closed kimchi pots. You feel the power of kimchi beneath you.

>sit
You are now seated on a closed kimchi pot. You stare at your toes, and wonder how they got there.

>sit
You continue to sit. Above you is the sky.

>sit
You continue to sit. A little bug buzzes by.

>sit
You continue to sit. Something around you smells... interesting.

>open pot
You open a kimchi pot, revealing more kimchi than you know what to do with.

>sit in pot
(getting off the closed kimchi pot)
You are now sitting in an open kimchi pot; the strong spicy odor surrounds you, and the cabbage is soft beneath you.

>sit
You are now seated in an open kimchi pot. A beam of sunlight crosses in front of you.

>sit
You continue to sit.

>sit
You continue to sit.

>l
Kimchi Pots (in the open kimchi pot)
If there was kimchi in one of those pots you could eat it... you could put it in your mouth and let the spices soak your tongue.

You could climb into one of the pots and sing until your voice was hoarse.

You could stand on top of one of them and jump up and down until someone made you stop.

You could do a million things. Or nothing at all.

In the open kimchi pot you can see a small mountain of kimchi.

>sing
You are now singing in an open kimchi pot. Tiny drums in your ears vibrate in time.

>sing
You continue to sing. You hear rain in the distance.

>sing
You continue to sing. You close your eyes for a moment... and almost fall asleep.

>sing
You continue to sing.

>sing
You continue to sing.

>smell kimchi
Smells like strongly spiced cabbage.

>smell kimchi
Smells like strongly spiced cabbage.

* * *

Being There

During the course of play you will be taken to a series of locations. In each location you can do various things by typing commands into the text prompt. Try things like:

listen
examine the stripe
touch the street
dance on the sidewalk
climb the tree
taste the flower

Please press SPACE to continue.

>jump on kimchi
The kimchi is (presumably) inside of those closed pots.

>jump on kimchi
The kimchi is (presumably) inside of those closed pots.

>jump on pot
You are now jumping on a closed kimchi pot. 

You jump up and down like a maniac on the ceramic lid of the kimchi pot. You better hope it doesn't break under you!

>jump on pot
The ceramic lid has had all the abuse it can take. It breaks. You land in a mountain of kimchi.

(getting off the closed kimchi pot)

* * *

Being There

During the course of play you will be taken to a series of locations. In each location you can do various things by typing commands into the text prompt. Try things like:

listen
examine the stripe
touch the street
dance on the sidewalk
climb the tree
taste the flower

Please press SPACE to continue.

>get on pot
You get onto the closed kimchi pot.

>get in pot
You'll need to open one of the pots first.

>touch pot
Pretty much what you would expect.

>touch open pot
Pretty much what you would expect.

>touch supporter-pot
The pots are glazed, and feel smooth and curvy.

* * *

Being There

During the course of play you will be taken to a series of locations. In each location you can do various things by typing commands into the text prompt. Try things like:

listen
examine the stripe
touch the street
dance on the sidewalk
climb the tree
taste the flower

Please press SPACE to continue.

>touch pot
The pots are glazed, and feel smooth and curvy.

>n
A Stream
You run far this time, and come upon a stream where a father plays with his two daughters.

>drink
(the stream)
You bend down, place your head in the stream, and open your mouth. The water rushes into your mouth, down your throat, and fills your stomach. Bloated, you fall over with a splash. You are now reclining in the stream.

>swim
(in the stream)
But you're already in the stream.
Some might say the water's a bit shallow for swimming, but that doesn't stop you from diving in head first and splashing about like a maniac.

>l
A Stream (in the stream)
A stream where a father plays with his two daughters.

>drink water
You bend down, place your head in the stream, and open your mouth. The water rushes into your mouth, down your throat, and fills your stomach. Bloated, you fall over with a splash. You are now reclining in the stream.

* * *

Being There

During the course of play you will be taken to a series of locations. In each location you can do various things by typing commands into the text prompt. Try things like:

listen
examine the stripe
touch the street
dance on the sidewalk
climb the tree
taste the flower

Please press SPACE to continue.

>swim in stream
Some might say the water's a bit shallow for swimming, but that doesn't stop you from diving in head first and splashing about like a maniac.

>l
A Stream (in the stream)
A stream where a father plays with his two daughters.